56,43
00,00,00,00,00,00,00,00,00,00,00,00,00,00,00,00,00,00,00,00,00,00,00,00,00,00,00,00,00,00,00,00,00,00,00,00,00,00,00,00,00,00,00,00,00,00,00,00,00,00,00,00,00,00,00,00
00,00,00,00,00,00,00,00,00,00,00,00,00,00,00,00,00,00,00,00,00,00,00,00,00,00,00,00,00,00,00,00,00,00,00,00,00,00,00,00,00,00,00,00,00,00,00,00,00,00,00,00,00,00,00,00
00,00,00,00,00,00,00,00,00,00,00,00,00,00,00,00,00,00,00,00,00,00,00,00,00,00,00,00,00,00,00,00,00,00,00,00,00,00,00,00,00,00,00,00,00,00,00,00,00,00,00,00,00,00,00,00
00,00,00,00,00,00,00,00,00,00,00,00,00,00,00,00,00,00,00,00,00,00,00,00,00,00,00,00,00,00,00,00,00,00,00,00,00,00,00,00,00,00,00,00,00,00,00,00,00,00,00,00,00,00,00,00
00,00,00,00,00,00,00,87,87,87,87,87,87,87,87,87,87,87,87,87,87,87,87,87,87,87,87,87,87,87,87,87,87,87,87,87,87,87,87,87,87,87,87,87,87,87,87,87,87,00,00,00,00,00,00,00
18,18,18,18,18,18,18,18,20,01,01,01,01,01,03,01,01,01,01,01,01,01,01,01,01,01,01,01,01,01,01,01,84,01,01,01,01,01,01,01,01,01,01,01,01,01,01,01,87,00,00,00,00,00,00,00
18,18,18,18,18,18,18,18,20,01,01,01,01,01,01,01,01,01,01,01,01,01,01,03,01,01,01,01,01,48,01,01,01,01,01,01,01,01,01,01,01,83,83,83,83,83,83,83,87,00,00,00,00,00,00,00
18,18,18,18,18,18,18,18,20,01,01,01,01,29,29,29,29,29,29,29,29,29,29,01,01,01,01,01,01,01,01,01,03,01,01,01,01,01,84,01,01,83,83,83,83,83,83,83,87,00,00,00,00,00,00,00
18,18,18,18,18,18,18,18,25,85,01,01,01,29,28,28,28,28,29,28,32,28,29,01,01,01,01,03,01,01,01,01,01,01,84,57,57,57,57,57,57,83,83,83,83,83,83,83,87,00,00,00,00,00,00,00
18,18,18,18,18,18,18,18,18,20,01,01,01,29,38,28,28,28,28,28,53,45,29,01,29,29,29,29,29,29,29,29,29,29,84,57,28,28,101,100,57,83,83,83,83,83,83,83,87,00,00,00,00,00,00,00
18,18,18,18,18,18,18,18,18,20,01,01,01,29,39,28,28,28,29,28,32,28,29,01,29,28,28,45,28,29,28,45,28,29,01,57,28,28,28,28,57,83,83,83,83,83,83,83,87,00,00,00,00,00,00,00
18,18,18,18,18,18,18,18,18,20,01,84,01,29,28,28,28,28,29,27,29,29,29,01,29,33,33,70,33,29,33,68,33,29,03,57,28,28,28,28,57,83,83,83,83,83,83,83,87,00,00,00,00,00,00,00
18,18,18,18,18,18,18,18,18,25,01,01,01,29,100,28,28,28,29,27,01,01,84,01,29,28,28,28,28,28,28,28,28,29,01,57,28,28,28,28,57,83,83,83,83,83,83,83,87,00,00,00,00,00,00,00
18,18,18,18,18,18,18,18,18,18,20,01,01,29,29,29,29,29,29,27,01,01,01,01,29,28,28,28,28,28,28,28,28,29,01,57,28,28,36,37,57,83,83,83,83,83,83,83,87,00,00,00,00,00,00,00
18,18,18,18,18,18,18,18,18,18,20,01,01,01,01,84,01,01,03,27,01,01,01,01,29,28,28,28,28,28,28,64,28,29,01,57,28,57,57,57,57,83,83,83,83,83,83,83,87,00,00,00,00,00,00,00
18,18,18,18,18,18,18,18,18,24,01,01,49,03,01,01,01,01,01,27,01,01,01,01,29,29,29,29,28,28,29,29,29,29,01,01,27,83,83,83,83,83,83,83,83,83,83,83,87,00,00,00,00,00,00,00
18,18,18,18,18,18,18,18,18,20,01,01,01,01,01,01,01,01,01,27,01,01,01,01,01,01,01,01,27,27,01,01,01,01,01,01,27,83,83,83,83,83,83,83,83,83,83,83,87,00,00,00,00,00,00,00
18,18,18,18,18,18,18,18,18,20,01,01,01,01,01,01,01,01,01,27,01,01,01,01,01,03,01,01,27,27,01,85,01,01,01,01,27,83,83,83,83,83,83,83,83,83,83,83,87,00,00,00,00,00,00,00
18,18,18,18,18,18,18,18,18,20,01,01,84,85,01,01,01,01,01,27,01,01,01,01,01,01,01,01,27,27,01,01,01,01,01,01,27,83,83,83,83,83,83,83,83,83,83,83,87,00,00,00,00,00,00,00
18,18,18,18,18,18,18,88,88,88,27,27,27,27,27,27,27,27,27,27,27,27,71,27,27,27,27,27,27,27,27,27,27,27,27,27,27,27,27,27,27,27,27,27,27,27,27,27,87,00,00,00,00,00,00,00
18,18,18,18,18,18,18,98,88,88,27,27,27,27,27,27,27,27,27,27,27,27,27,27,27,27,27,27,27,27,27,27,27,27,27,27,27,27,27,27,27,27,27,27,27,27,27,27,87,00,00,00,00,00,00,00
18,18,18,18,18,18,18,18,18,20,01,01,01,03,01,01,01,27,01,01,01,01,01,01,01,27,01,01,01,01,01,01,03,27,01,01,01,01,01,01,01,27,01,01,01,01,01,01,87,00,00,00,00,00,00,00
18,18,18,18,18,18,18,18,18,20,01,01,01,01,01,01,01,27,01,01,84,01,01,01,01,27,01,01,01,01,01,01,01,27,01,01,01,01,01,01,01,27,01,01,01,01,01,01,87,00,00,00,00,00,00,00
18,18,18,18,18,18,18,18,24,01,01,01,01,05,05,05,05,28,05,01,01,01,01,01,01,27,01,01,01,01,01,01,01,27,01,01,01,01,01,01,01,27,01,01,01,01,01,01,87,00,00,00,00,00,00,00
18,18,18,18,18,18,18,18,20,01,01,01,01,05,28,28,28,28,05,01,01,01,01,01,01,27,01,01,01,29,29,29,29,28,29,29,01,01,03,84,29,28,29,29,29,29,29,03,87,00,00,00,00,00,00,00
18,18,18,18,18,18,18,18,20,01,01,85,01,05,28,28,28,28,05,01,01,01,01,01,03,27,03,01,01,29,36,37,28,28,28,29,01,01,01,01,29,28,28,28,28,28,29,85,87,00,00,00,00,00,00,00
18,18,18,18,18,18,18,18,20,01,01,01,01,05,99,67,28,100,05,01,01,01,84,01,03,27,03,01,01,29,28,28,28,28,28,29,01,01,01,01,29,28,28,28,28,28,29,85,87,00,00,00,00,00,00,00
18,18,18,18,18,18,18,18,25,01,01,01,01,05,05,05,05,05,05,01,01,01,29,29,29,28,29,29,01,29,28,28,74,28,28,29,01,01,01,01,29,33,33,66,33,33,29,01,87,00,00,00,00,00,00,00
18,18,18,18,18,18,18,18,18,20,03,01,01,01,01,01,84,01,01,01,01,01,29,28,28,28,28,29,01,29,99,28,28,36,37,29,01,01,03,01,29,28,28,45,28,28,29,01,87,00,00,00,00,00,00,00
18,18,18,18,18,18,18,18,18,20,01,01,01,01,01,01,01,01,01,01,01,01,29,28,28,28,28,29,84,29,29,29,29,29,29,29,01,01,01,01,29,29,29,29,29,29,29,01,87,00,00,00,00,00,00,00
18,18,18,18,18,18,18,18,18,20,01,01,01,01,85,01,01,01,01,01,01,01,29,28,38,28,28,29,01,01,01,85,01,01,01,01,01,01,01,01,01,01,01,01,01,01,01,01,87,00,00,00,00,00,00,00
18,18,18,18,18,18,18,18,18,20,01,01,01,01,01,01,01,01,01,01,01,01,29,28,39,28,28,29,29,29,29,29,29,29,29,01,01,01,03,01,01,01,01,03,01,01,01,01,87,00,00,00,00,00,00,00
18,18,18,18,18,18,18,18,18,20,01,01,01,01,01,01,03,01,01,01,03,01,29,28,28,28,28,28,28,28,28,28,32,28,29,01,01,01,01,01,01,01,01,01,01,01,01,01,87,00,00,00,00,00,00,00
18,18,18,18,18,18,18,18,24,84,01,01,01,01,01,03,01,01,01,01,01,01,29,28,38,28,28,28,36,37,52,28,32,28,29,03,01,01,01,01,01,84,01,01,01,01,01,01,87,00,00,00,00,00,00,00
18,18,18,18,18,18,18,18,20,01,01,85,01,01,01,01,01,01,01,01,01,01,29,28,39,51,28,28,28,28,28,28,47,45,29,01,01,01,01,01,01,01,01,01,01,01,01,01,87,00,00,00,00,00,00,00
18,18,18,18,18,18,18,18,20,01,01,01,01,01,01,01,01,01,01,01,01,01,29,28,28,28,28,28,36,37,28,28,32,28,29,01,01,01,03,01,01,01,50,01,01,01,84,84,87,00,00,00,00,00,00,00
18,18,18,18,18,18,18,24,01,01,01,01,01,01,01,01,01,01,01,01,01,01,29,28,28,28,28,28,28,28,28,28,32,28,29,01,01,01,01,01,01,01,01,01,01,84,85,84,87,00,00,00,00,00,00,00
18,18,18,18,18,18,18,20,01,01,01,03,01,01,01,01,01,01,84,84,01,01,29,29,29,29,29,29,29,29,29,29,29,29,29,01,01,01,01,03,01,01,01,01,84,84,84,84,87,00,00,00,00,00,00,00
00,00,00,00,00,00,00,87,87,87,87,87,87,87,87,87,87,87,87,87,87,87,87,87,87,87,87,87,87,87,87,87,87,87,87,87,87,87,87,87,87,87,87,87,87,87,87,87,87,00,00,00,00,00,00,00
00,00,00,00,00,00,00,00,00,00,00,00,00,00,00,00,00,00,00,00,00,00,00,00,00,00,00,00,00,00,00,00,00,00,00,00,00,00,00,00,00,00,00,00,00,00,00,00,00,00,00,00,00,00,00,00
00,00,00,00,00,00,00,00,00,00,00,00,00,00,00,00,00,00,00,00,00,00,00,00,00,00,00,00,00,00,00,00,00,00,00,00,00,00,00,00,00,00,00,00,00,00,00,00,00,00,00,00,00,00,00,00
00,00,00,00,00,00,00,00,00,00,00,00,00,00,00,00,00,00,00,00,00,00,00,00,00,00,00,00,00,00,00,00,00,00,00,00,00,00,00,00,00,00,00,00,00,00,00,00,00,00,00,00,00,00,00,00
00,00,00,00,00,00,00,00,00,00,00,00,00,00,00,00,00,00,00,00,00,00,00,00,00,00,00,00,00,00,00,00,00,00,00,00,00,00,00,00,00,00,00,00,00,00,00,00,00,00,00,00,00,00,00,00