35,35
00,00,00,00,00,00,00,00,00,00,00,00,00,00,00,00,00,00,00,00,00,00,00,00,00,00,00,00,00,00,00,00,00,00,00
00,00,00,00,00,00,00,00,00,00,00,00,00,00,00,00,00,00,00,00,00,00,00,00,00,00,00,00,00,00,00,00,00,00,00
00,00,00,00,00,00,00,00,00,00,00,00,00,00,00,00,00,00,00,00,00,00,00,00,00,00,00,00,00,00,00,00,00,00,00
00,00,00,00,00,00,00,00,00,00,00,00,00,00,00,00,00,00,00,00,00,00,00,00,00,00,00,00,00,00,00,00,00,00,00
00,00,00,00,00,00,00,87,87,87,87,87,87,87,87,87,87,87,87,87,87,87,87,87,87,87,87,87,00,00,00,00,00,00,00
00,00,00,00,00,00,00,87,01,01,01,01,03,01,01,01,01,01,01,01,01,01,01,01,01,84,01,87,00,00,00,00,00,00,00
00,00,00,00,00,00,00,87,01,01,01,29,29,29,29,29,29,29,29,29,29,29,29,29,01,01,01,87,00,00,00,00,00,00,00
00,00,00,00,00,00,00,87,01,01,01,29,100,99,28,28,29,45,29,36,37,36,37,29,01,01,03,87,00,00,00,00,00,00,00
00,00,00,00,00,00,00,87,01,85,01,29,28,28,28,28,29,69,29,28,28,28,28,29,01,01,01,87,00,00,00,00,00,00,00
00,00,00,00,00,00,00,87,01,01,01,29,28,64,28,28,29,28,29,28,28,28,28,29,01,01,01,87,00,00,00,00,00,00,00
00,00,00,00,00,00,00,87,01,01,03,29,28,28,28,28,28,28,28,28,28,28,28,29,01,01,01,87,00,00,00,00,00,00,00
00,00,00,00,00,00,00,87,01,48,01,29,99,28,36,37,29,28,29,28,100,28,99,29,01,01,01,87,00,00,00,00,00,00,00
00,00,00,00,00,00,00,87,01,01,03,29,29,29,29,29,29,28,29,29,29,29,29,29,84,01,01,87,00,00,00,00,00,00,00
00,00,00,00,00,00,00,87,01,01,01,01,01,01,01,01,84,40,84,01,01,01,01,01,01,01,01,87,00,00,00,00,00,00,00
00,00,00,00,00,00,00,87,01,03,01,01,01,01,01,01,01,40,01,01,03,01,49,01,01,01,01,87,00,00,00,00,00,00,00
00,00,00,00,00,00,00,87,01,01,01,01,01,84,01,01,01,40,01,01,01,01,01,01,01,03,01,87,00,00,00,00,00,00,00
00,00,00,00,00,00,00,87,01,29,29,29,29,29,01,01,01,40,01,01,01,01,01,01,01,01,01,87,00,00,00,00,00,00,00
00,00,00,00,00,00,00,87,01,29,28,32,28,29,01,01,01,40,01,01,01,01,85,01,01,01,01,87,00,00,00,00,00,00,00
00,00,00,00,00,00,00,87,01,29,28,32,28,29,01,01,03,40,03,01,01,01,01,01,01,01,01,87,00,00,00,00,00,00,00
00,00,00,00,00,00,00,87,01,29,45,54,28,28,40,40,40,40,01,01,01,01,01,01,01,01,03,87,00,00,00,00,00,00,00
00,00,00,00,00,00,00,87,01,29,28,32,28,29,01,01,01,40,01,01,01,29,29,29,29,29,01,87,00,00,00,00,00,00,00
00,00,00,00,00,00,00,87,01,29,28,32,28,29,01,01,01,40,01,01,03,29,38,28,99,29,01,87,00,00,00,00,00,00,00
00,00,00,00,00,00,00,87,01,29,29,29,29,29,01,01,01,40,03,01,01,29,39,28,63,29,01,87,00,00,00,00,00,00,00
00,00,00,00,00,00,00,87,01,01,01,03,84,84,01,01,01,40,40,40,40,28,28,28,28,29,01,87,00,00,00,00,00,00,00
00,00,00,00,00,00,00,87,01,01,01,01,01,01,01,01,01,40,01,01,01,29,28,28,28,29,85,87,00,00,00,00,00,00,00
00,00,00,00,00,00,00,87,01,01,01,01,01,01,01,01,01,40,01,01,01,29,28,28,100,29,01,87,00,00,00,00,00,00,00
00,00,00,00,00,00,00,87,03,01,01,01,01,01,01,01,01,40,01,01,01,29,29,29,29,29,01,87,00,00,00,00,00,00,00
00,00,00,00,00,00,00,87,01,01,01,01,01,03,01,01,01,40,50,01,01,01,01,01,01,01,01,87,00,00,00,00,00,00,00
00,00,00,00,00,00,00,87,01,01,01,01,01,01,01,01,01,40,01,01,01,85,84,01,84,01,01,87,00,00,00,00,00,00,00
00,00,00,00,00,00,00,87,01,01,84,01,01,01,01,01,01,40,01,01,01,01,01,01,01,01,01,87,00,00,00,00,00,00,00
00,00,00,00,00,00,00,87,87,87,87,87,87,87,87,87,87,87,87,87,87,87,87,87,87,87,87,87,00,00,00,00,00,00,00
00,00,00,00,00,00,00,00,00,00,00,00,00,00,00,00,00,00,00,00,00,00,00,00,00,00,00,00,00,00,00,00,00,00,00
00,00,00,00,00,00,00,00,00,00,00,00,00,00,00,00,00,00,00,00,00,00,00,00,00,00,00,00,00,00,00,00,00,00,00
00,00,00,00,00,00,00,00,00,00,00,00,00,00,00,00,00,00,00,00,00,00,00,00,00,00,00,00,00,00,00,00,00,00,00
00,00,00,00,00,00,00,00,00,00,00,00,00,00,00,00,00,00,00,00,00,00,00,00,00,00,00,00,00,00,00,00,00,00,00