34,28
02,02,02,02,02,02,02,02,02,02,02,02,02,02,02,02,02,02,02,02,02,02,02,02,02,02,02,02,02,02,02,02,02,02
02,02,02,02,02,02,02,02,02,02,02,02,02,02,02,02,02,02,02,02,02,02,02,02,02,02,02,02,02,02,02,02,02,02
02,02,02,02,02,02,02,02,02,02,02,02,02,02,02,02,02,02,02,02,02,02,02,02,02,02,02,02,02,02,02,02,02,02
02,02,02,02,02,02,02,02,02,02,02,02,02,02,02,02,02,02,02,02,02,02,02,02,02,02,02,02,02,02,02,02,02,02
02,02,02,02,02,02,02,02,02,02,02,02,02,02,02,02,02,02,02,02,02,02,02,02,02,02,02,02,02,02,02,02,02,02
02,02,02,02,02,02,02,02,40,40,40,40,61,02,02,02,02,59,40,40,40,02,02,40,40,40,02,02,02,02,02,02,02,02
02,02,02,02,02,02,02,02,40,02,02,02,02,40,40,59,02,02,02,02,40,40,02,40,02,40,02,02,02,02,02,02,02,02
02,02,02,02,02,02,02,02,40,02,61,40,02,40,02,02,02,02,02,02,02,40,02,40,02,40,02,02,02,02,02,02,02,02
02,02,02,02,02,02,02,02,40,02,02,40,02,40,61,02,59,40,40,40,02,61,02,40,02,59,02,02,02,02,02,02,02,02
02,02,02,02,02,02,02,02,59,02,02,40,02,40,02,02,02,02,02,40,02,02,02,40,02,02,02,02,02,02,02,02,02,02
02,02,02,02,02,02,02,02,02,02,02,40,02,40,40,61,02,02,02,40,59,02,61,40,40,40,02,02,02,02,02,02,02,02
02,02,02,02,02,02,02,02,40,61,02,61,02,02,02,02,02,02,02,40,02,02,02,02,40,02,02,02,02,02,02,02,02,02
02,02,02,02,02,02,02,02,40,02,02,02,02,02,02,59,02,02,61,40,40,40,59,02,40,02,02,02,02,02,02,02,02,02
02,02,02,02,02,02,02,02,40,02,02,61,40,40,02,40,02,02,02,02,02,02,02,02,61,02,02,02,02,02,02,02,02,02
02,02,02,02,02,02,02,02,40,02,02,02,02,40,02,40,02,40,40,40,61,02,61,02,02,02,02,02,02,02,02,02,02,02
02,02,02,02,02,02,02,02,40,02,02,02,02,40,02,40,02,40,02,02,02,02,40,59,02,02,02,02,02,02,02,02,02,02
02,02,02,02,02,02,02,02,40,40,40,40,40,40,40,40,02,40,59,02,02,02,02,02,02,02,02,02,02,02,02,02,02,02
02,02,02,02,02,02,02,02,02,02,02,02,02,02,02,02,02,40,02,02,59,40,40,59,02,61,02,02,02,02,02,02,02,02
02,02,02,02,02,02,02,02,59,40,40,40,59,02,61,40,40,40,02,02,02,02,40,02,02,40,02,02,02,02,02,02,02,02
02,02,02,02,02,02,02,02,40,02,02,02,40,02,02,02,02,61,02,59,02,02,40,02,02,40,02,02,02,02,02,02,02,02
02,02,02,02,02,02,02,02,40,02,02,02,40,02,40,59,02,02,02,40,02,02,40,02,02,40,02,02,02,02,02,02,02,02
02,02,02,02,02,02,02,02,40,02,02,02,40,02,40,02,02,02,02,40,02,59,40,40,02,40,02,02,02,02,02,02,02,02
02,02,02,02,02,02,02,02,40,40,40,40,61,02,40,40,40,40,40,40,02,02,02,61,02,59,02,02,02,02,02,02,02,02
02,02,02,02,02,02,02,02,02,02,02,02,02,02,02,02,02,02,02,02,02,02,02,02,02,02,02,02,02,02,02,02,02,02
02,02,02,02,02,02,02,02,02,02,02,02,02,02,02,02,02,02,02,02,02,02,02,02,02,02,02,02,02,02,02,02,02,02
02,02,02,02,02,02,02,02,02,02,02,02,02,02,02,02,02,02,02,02,02,02,02,02,02,02,02,02,02,02,02,02,02,02
02,02,02,02,02,02,02,02,02,02,02,02,02,02,02,02,02,02,02,02,02,02,02,02,02,02,02,02,02,02,02,02,02,02
02,02,02,02,02,02,02,02,02,02,02,02,02,02,02,02,02,02,02,02,02,02,02,02,02,02,02,02,02,02,02,02,02,02