25,16
09,09,09,09,09,09,09,09,09,09,09,09,09,09,09,09,09,09,09,09,09,09,09,09,09
09,09,09,09,09,09,09,09,09,09,09,09,09,09,09,09,09,09,09,09,09,09,09,09,09
09,09,09,09,09,09,09,09,09,09,09,09,09,09,09,09,09,09,09,09,09,09,09,09,09
09,09,09,09,09,09,09,09,09,09,09,09,09,09,09,09,09,09,09,09,09,09,09,09,09
09,09,09,09,09,09,09,09,09,09,09,09,09,09,09,09,09,09,09,09,09,09,09,09,09
09,09,09,09,09,09,09,09,10,02,02,02,02,02,83,83,11,09,09,09,09,09,09,09,09
09,09,09,09,09,09,09,09,10,02,28,60,100,02,83,83,11,09,09,09,09,09,09,09,09
09,09,09,09,09,09,09,09,10,02,28,28,28,02,83,83,11,09,09,09,09,09,09,09,09
09,09,09,09,09,09,09,09,10,02,99,28,28,02,83,83,85,11,09,09,09,09,09,09,09
09,09,09,09,09,09,09,09,10,02,02,01,02,02,83,83,03,11,09,09,09,09,09,09,09
09,09,09,09,09,09,09,09,10,85,01,01,84,01,01,01,11,09,09,09,09,09,09,09,09
09,09,09,09,09,09,09,09,07,07,07,08,61,06,07,07,07,09,09,09,09,09,09,09,09
09,09,09,09,09,09,09,09,09,09,09,09,07,09,09,09,09,09,09,09,09,09,09,09,09
09,09,09,09,09,09,09,09,09,09,09,09,09,09,09,09,09,09,09,09,09,09,09,09,09
09,09,09,09,09,09,09,09,09,09,09,09,09,09,09,09,09,09,09,09,09,09,09,09,09
09,09,09,09,09,09,09,09,09,09,09,09,09,09,09,09,09,09,09,09,09,09,09,09,09