42,40
01,01,01,01,01,01,01,01,01,01,01,01,01,01,01,01,01,01,01,01,01,01,01,01,01,01,01,01,01,01,01,01,01,01,01,01,01,01,01,01,01,01
01,01,01,01,01,01,01,01,01,01,01,01,01,01,01,01,01,01,01,01,01,01,01,01,01,01,01,01,01,01,01,01,01,01,01,01,01,01,01,01,01,01
01,01,01,01,01,01,01,01,01,01,01,01,01,01,01,01,01,01,01,01,01,01,01,01,01,01,01,01,01,01,01,01,01,01,01,01,01,01,01,01,01,01
01,01,01,01,01,01,01,01,01,01,01,01,01,01,01,01,01,01,01,01,01,01,01,01,01,01,01,01,01,01,01,01,01,01,01,01,01,01,01,01,01,01
01,01,01,01,01,01,01,29,29,29,29,29,29,29,29,29,29,29,29,29,29,29,29,29,29,29,29,29,29,29,29,29,29,29,29,01,01,01,01,01,01,01
01,01,01,01,01,01,01,29,40,40,40,40,40,40,40,40,40,40,40,40,40,40,118,40,40,40,40,40,40,40,40,40,40,40,29,01,01,01,01,01,01,01
01,01,01,01,01,01,01,29,40,40,40,40,40,40,40,40,40,40,40,40,40,40,40,40,40,40,40,40,40,40,40,40,40,40,29,01,01,01,01,01,01,01
01,01,01,01,01,01,01,29,40,40,29,29,29,29,29,29,29,29,29,29,29,29,29,29,29,29,29,29,29,29,29,29,40,40,29,01,01,01,01,01,01,01
01,01,01,01,01,01,01,29,40,40,29,40,40,40,40,40,40,40,40,40,119,29,28,28,28,28,28,28,28,28,28,29,40,40,29,01,01,01,01,01,01,01
01,01,01,01,01,01,01,29,40,40,29,40,29,29,29,29,40,29,29,29,29,29,28,28,36,37,28,36,37,28,28,29,40,40,29,01,01,01,01,01,01,01
01,01,01,01,01,01,01,29,40,40,29,40,29,40,40,29,40,29,40,40,40,29,28,28,28,28,28,28,28,28,28,29,40,40,29,01,01,01,01,01,01,01
01,01,01,01,01,01,01,29,40,40,29,40,29,40,40,117,40,117,40,40,40,29,28,28,36,37,28,36,37,28,28,29,40,40,29,01,01,01,01,01,01,01
01,01,01,01,01,01,01,29,40,40,29,40,29,40,40,29,40,29,40,40,40,29,28,28,28,28,28,28,28,28,28,29,40,40,29,01,01,01,01,01,01,01
01,01,01,01,01,01,01,29,40,40,29,40,29,29,29,29,40,29,29,29,29,29,28,28,36,37,28,36,37,28,28,29,40,40,29,01,01,01,01,01,01,01
01,01,01,01,01,01,01,29,40,40,29,40,29,40,40,29,40,29,40,40,40,29,28,28,28,28,28,28,28,28,28,29,40,40,29,01,01,01,01,01,01,01
01,01,01,01,01,01,01,29,40,40,29,40,29,40,40,117,40,117,78,40,40,29,28,28,36,37,28,36,37,28,28,29,40,40,29,01,01,01,01,01,01,01
01,01,01,01,01,01,01,29,40,40,29,40,29,40,40,29,40,29,40,40,40,29,28,28,28,28,28,28,28,28,28,29,40,40,29,01,01,01,01,01,01,01
01,01,01,01,01,01,01,29,40,40,29,40,29,29,29,29,29,29,29,29,29,29,29,29,29,40,40,40,29,29,29,29,40,40,29,01,01,01,01,01,01,01
01,01,01,01,01,01,01,29,40,40,29,40,40,40,40,40,40,40,40,40,40,40,40,40,40,40,40,40,40,40,40,29,40,40,29,01,01,01,01,01,01,01
01,01,01,01,01,01,01,29,40,40,29,40,29,29,29,29,29,29,29,40,29,29,29,29,29,40,29,29,29,29,29,29,40,40,29,01,01,01,01,01,01,01
01,01,01,01,01,01,01,29,40,40,29,40,29,40,40,40,40,40,29,40,29,40,40,40,29,40,29,36,37,36,37,29,40,40,29,01,01,01,01,01,01,01
01,01,01,01,01,01,01,29,40,40,29,40,29,40,40,40,40,40,29,40,29,40,123,40,29,40,29,28,28,28,28,29,40,40,29,01,01,01,01,01,01,01
01,01,01,01,01,01,01,29,40,40,29,40,29,40,118,40,40,40,29,40,29,40,40,40,29,40,29,28,28,28,28,29,40,40,29,01,01,01,01,01,01,01
01,01,01,01,01,01,01,29,40,40,29,40,29,40,40,40,40,40,29,40,29,40,40,40,29,40,29,28,28,28,38,29,40,40,29,01,01,01,01,01,01,01
01,01,01,01,01,01,01,29,40,40,29,40,29,29,29,29,29,40,29,40,29,29,40,29,29,40,29,28,120,28,39,29,40,40,29,01,01,01,01,01,01,01
01,01,01,01,01,01,01,29,40,40,29,40,40,40,40,40,40,40,29,40,29,40,40,40,29,40,29,28,28,28,28,29,40,40,29,01,01,01,01,01,01,01
01,01,01,01,01,01,01,29,40,40,29,29,29,29,29,29,29,40,29,40,29,40,40,40,29,40,29,28,28,28,38,29,40,40,29,01,01,01,01,01,01,01
01,01,01,01,01,01,01,29,40,40,29,40,40,40,40,40,40,40,29,40,29,40,40,40,40,40,40,28,28,28,39,29,40,40,29,01,01,01,01,01,01,01
01,01,01,01,01,01,01,29,40,40,29,40,40,40,40,40,40,40,29,40,29,40,118,40,29,40,29,28,28,28,28,29,40,40,29,01,01,01,01,01,01,01
01,01,01,01,01,01,01,29,40,40,29,40,122,40,40,40,40,40,29,40,29,40,40,40,29,40,29,28,28,28,28,29,40,40,29,01,01,01,01,01,01,01
01,01,01,01,01,01,01,29,40,40,29,40,40,40,40,40,40,40,29,40,29,40,40,40,29,40,29,28,28,36,37,29,40,40,29,01,01,01,01,01,01,01
01,01,01,01,01,01,01,29,40,40,29,29,29,29,29,29,29,29,29,40,29,29,29,29,29,29,29,29,29,29,29,29,40,40,29,01,01,01,01,01,01,01
01,01,01,01,01,01,01,29,118,40,40,40,40,40,40,40,40,40,40,40,40,40,40,40,40,40,40,40,40,40,40,40,40,40,29,01,01,01,01,01,01,01
01,01,01,01,01,01,01,29,40,40,40,40,40,40,40,40,40,40,40,40,40,40,40,40,40,40,40,40,40,40,40,40,40,40,29,01,01,01,01,01,01,01
01,01,01,01,01,01,01,29,29,29,29,29,29,29,29,29,29,29,40,40,40,29,29,29,29,29,29,29,29,29,29,29,29,29,29,01,01,01,01,01,01,01
01,01,01,01,01,01,01,01,01,01,01,01,01,01,01,01,01,01,01,01,01,01,01,01,01,01,01,01,01,01,01,01,01,01,01,01,01,01,01,01,01,01
01,01,01,01,01,01,01,01,01,01,01,01,01,01,01,01,01,01,01,01,01,01,01,01,01,01,01,01,01,01,01,01,01,01,01,01,01,01,01,01,01,01
01,01,01,01,01,01,01,01,01,01,01,01,01,01,01,01,01,01,01,01,01,01,01,01,01,01,01,01,01,01,01,01,01,01,01,01,01,01,01,01,01,01
01,01,01,01,01,01,01,01,01,01,01,01,01,01,01,01,01,01,01,01,01,01,01,01,01,01,01,01,01,01,01,01,01,01,01,01,01,01,01,01,01,01
01,01,01,01,01,01,01,01,01,01,01,01,01,01,01,01,01,01,01,01,01,01,01,01,01,01,01,01,01,01,01,01,01,01,01,01,01,01,01,01,01,01