74,68
00,00,00,00,00,00,00,00,00,00,00,00,00,00,00,00,00,00,00,00,00,00,00,00,00,00,00,00,00,00,00,00,00,00,00,00,00,00,00,00,00,00,00,00,00,00,00,00,00,00,00,00,00,00,00,00,00,00,00,00,00,00,00,00,00,00,00,00,00,00,00,00,00,00
00,00,00,00,00,00,00,00,00,00,00,00,00,00,00,00,00,00,00,00,00,00,00,00,00,00,00,00,00,00,00,00,00,00,00,00,00,00,00,00,00,00,00,00,00,00,00,00,00,00,00,00,00,00,00,00,00,00,00,00,00,00,00,00,00,00,00,00,00,00,00,00,00,00
00,00,00,00,00,00,00,00,00,00,00,00,00,00,00,00,00,00,00,00,00,00,00,00,00,00,00,00,00,00,00,00,00,00,00,00,00,00,00,00,00,00,00,00,00,00,00,00,00,00,00,00,00,00,00,00,00,00,00,00,00,00,00,00,00,00,00,00,00,00,00,00,00,00
00,00,00,00,00,00,00,00,00,00,00,00,00,00,00,00,00,00,00,00,00,00,00,00,00,00,00,00,00,00,00,00,00,00,00,00,00,00,00,00,00,00,00,00,00,00,00,00,00,00,00,00,00,00,00,00,00,00,00,00,00,00,00,00,00,00,00,00,00,00,00,00,00,00
00,00,00,00,00,00,00,02,02,02,02,02,02,02,02,02,02,02,02,02,02,02,02,02,02,02,02,02,02,02,02,02,02,02,02,02,02,02,02,02,02,02,02,02,02,02,02,02,02,02,02,02,02,02,02,02,02,02,02,02,02,02,02,02,02,02,02,00,00,00,00,00,00,00
00,00,00,00,00,00,00,02,02,02,02,02,02,02,02,02,02,02,02,02,02,02,02,02,02,43,40,40,40,40,40,02,02,02,02,02,02,02,02,02,02,02,02,40,40,40,40,40,40,40,40,40,40,44,40,02,02,02,02,02,02,02,02,02,02,02,02,00,00,00,00,00,00,00
00,00,00,00,00,00,00,02,02,02,02,02,02,02,02,02,02,02,02,02,02,02,02,02,02,02,02,02,02,40,40,02,02,02,02,02,02,02,02,02,02,02,02,40,02,02,02,02,02,02,44,02,02,02,02,02,02,40,40,40,40,40,43,43,02,02,02,00,00,00,00,00,00,00
00,00,00,00,00,00,00,02,44,40,40,40,40,40,40,40,40,40,40,40,40,40,02,02,02,02,02,02,02,40,40,02,02,02,02,02,02,02,02,02,02,02,02,40,02,02,02,02,02,02,02,02,02,02,02,02,02,40,40,40,40,40,40,02,02,02,02,00,00,00,00,00,00,00
00,00,00,00,00,00,00,02,40,40,40,40,40,40,40,40,40,40,40,40,40,40,02,02,02,02,02,02,02,40,40,02,02,02,02,02,44,02,02,02,02,02,02,40,02,02,02,02,02,02,40,40,40,40,40,40,40,40,40,02,02,40,40,02,02,02,02,00,00,00,00,00,00,00
00,00,00,00,00,00,00,02,40,40,40,40,40,40,40,40,40,40,40,40,40,40,02,02,02,02,02,02,02,40,40,02,02,02,02,02,40,40,40,02,02,02,02,40,02,02,02,02,02,02,40,40,40,40,40,40,40,40,40,02,02,40,40,02,02,02,02,00,00,00,00,00,00,00
00,00,00,00,00,00,00,02,40,40,02,02,02,40,40,40,40,40,40,44,40,40,40,40,40,40,40,40,40,40,40,44,40,40,40,40,40,40,40,40,40,40,40,40,40,40,40,40,40,40,43,40,40,40,40,40,40,40,40,02,02,40,40,40,02,02,02,00,00,00,00,00,00,00
00,00,00,00,00,00,00,02,40,40,02,02,02,40,40,02,02,40,40,40,40,40,40,40,40,40,40,40,40,40,40,40,40,40,40,40,40,40,40,40,40,44,40,40,40,40,40,40,40,40,40,40,40,40,40,40,40,40,40,43,40,40,40,40,02,02,02,00,00,00,00,00,00,00
00,00,00,00,00,00,00,02,40,40,02,02,02,40,40,02,02,40,40,40,40,40,40,40,40,40,40,40,40,40,40,40,40,40,40,40,02,44,02,02,02,02,02,02,02,02,02,02,02,02,02,02,02,02,02,40,40,40,40,40,40,40,40,40,02,02,02,00,00,00,00,00,00,00
00,00,00,00,00,00,00,02,40,40,02,02,02,40,40,40,40,40,40,02,02,40,40,40,40,40,40,40,40,40,40,40,40,40,40,40,02,02,02,02,02,02,02,02,02,02,02,02,02,02,02,02,02,02,02,40,40,40,40,40,40,40,40,40,02,02,02,00,00,00,00,00,00,00
00,00,00,00,00,00,00,02,40,40,02,02,02,40,40,40,40,40,40,02,02,40,40,40,40,40,40,40,40,40,40,40,40,40,40,40,02,02,02,02,02,02,02,02,02,02,02,02,02,02,02,02,02,02,02,40,40,40,40,40,40,40,40,40,02,02,02,00,00,00,00,00,00,00
00,00,00,00,00,00,00,02,40,40,02,02,02,43,40,40,40,40,40,40,40,44,40,02,02,02,02,02,02,02,02,02,02,02,02,02,02,02,02,02,02,02,02,02,02,02,02,02,02,02,02,02,02,02,02,40,40,40,40,40,40,40,40,40,02,02,02,00,00,00,00,00,00,00
00,00,00,00,00,00,00,02,44,40,02,02,02,02,02,02,02,02,02,02,02,02,02,02,02,02,02,02,02,02,02,02,02,02,02,02,02,02,02,02,02,02,02,02,02,02,02,02,02,02,02,02,02,02,02,44,40,40,40,40,40,40,40,40,02,02,02,00,00,00,00,00,00,00
00,00,00,00,00,00,00,02,44,40,02,02,02,02,02,02,02,02,02,02,02,02,02,02,02,02,02,02,02,02,02,02,02,02,02,02,02,02,02,02,40,44,44,40,40,40,40,40,40,40,40,40,40,44,40,40,40,40,40,40,40,40,40,40,02,02,02,00,00,00,00,00,00,00
00,00,00,00,00,00,00,02,40,40,02,02,02,43,44,40,40,40,40,40,40,40,40,40,40,02,43,02,02,02,02,02,02,02,02,02,02,02,02,02,44,40,40,40,40,40,40,40,40,40,40,40,40,40,40,40,40,40,40,40,44,02,02,02,02,02,02,00,00,00,00,00,00,00
00,00,00,00,00,00,00,02,40,40,02,02,02,44,44,40,40,40,40,40,40,40,40,40,40,40,40,40,40,02,02,02,02,02,02,02,40,02,02,02,40,40,40,40,40,40,40,40,40,40,40,40,40,40,40,40,40,40,40,40,40,02,02,02,02,02,02,00,00,00,00,00,00,00
00,00,00,00,00,00,00,02,02,02,02,02,02,40,40,40,40,40,40,40,40,40,40,40,40,40,40,40,40,40,40,40,40,40,40,40,40,02,02,02,40,40,40,40,40,40,40,40,40,40,40,40,40,40,40,40,40,40,40,40,40,02,02,02,02,02,02,00,00,00,00,00,00,00
00,00,00,00,00,00,00,02,02,02,02,02,02,40,40,40,40,40,40,40,40,40,40,40,40,40,40,40,40,40,40,40,40,40,40,40,40,02,02,02,40,40,40,02,02,02,02,02,40,40,40,40,44,40,40,40,40,40,40,40,40,02,02,02,02,02,02,00,00,00,00,00,00,00
00,00,00,00,00,00,00,02,02,02,02,02,02,40,40,40,40,40,40,40,40,40,40,44,40,40,40,40,44,40,40,40,40,40,02,02,02,02,02,02,40,40,40,02,02,02,02,02,40,40,40,40,02,02,02,02,02,40,40,40,40,02,02,02,02,02,02,00,00,00,00,00,00,00
00,00,00,00,00,00,00,02,02,02,02,02,02,40,40,40,40,40,40,02,02,02,02,02,02,02,02,02,02,02,02,40,40,40,02,02,02,02,02,02,40,43,40,02,02,02,02,02,40,40,40,40,02,02,02,02,02,40,40,40,40,02,02,02,02,02,02,00,00,00,00,00,00,00
00,00,00,00,00,00,00,02,02,02,02,02,02,40,40,40,40,40,40,02,02,02,02,02,02,02,02,02,02,02,02,40,40,40,02,02,02,02,02,02,40,40,40,02,02,02,02,02,40,40,40,40,02,02,02,02,02,40,40,40,40,02,02,02,02,02,02,00,00,00,00,00,00,00
00,00,00,00,00,00,00,02,02,02,02,02,02,40,40,40,40,40,40,02,02,02,02,02,02,02,02,02,02,02,02,40,40,40,02,02,02,02,02,02,40,40,40,02,02,02,02,02,40,40,40,40,02,02,02,02,02,40,40,40,40,02,02,02,02,02,02,00,00,00,00,00,00,00
00,00,00,00,00,00,00,02,02,02,02,02,02,40,40,40,40,40,40,02,02,02,02,02,02,02,02,02,02,02,02,40,43,40,02,02,02,02,02,02,40,40,40,02,02,02,02,02,02,02,02,43,40,40,40,40,40,40,40,40,40,02,02,02,02,02,02,00,00,00,00,00,00,00
00,00,00,00,00,00,00,02,40,40,40,40,40,40,40,40,44,40,40,02,02,02,02,02,02,02,02,02,02,02,02,40,40,40,40,40,40,40,40,40,40,40,40,02,02,02,02,02,02,02,02,40,40,40,40,40,40,40,40,40,40,02,02,02,02,02,02,00,00,00,00,00,00,00
00,00,00,00,00,00,00,02,40,40,40,40,40,40,40,44,40,40,40,02,02,02,02,02,02,02,02,02,02,02,02,40,40,40,40,40,40,40,40,40,40,02,02,02,02,02,02,02,02,02,02,40,40,40,40,40,40,40,40,40,40,02,02,02,02,02,02,00,00,00,00,00,00,00
00,00,00,00,00,00,00,02,40,40,40,40,40,40,40,40,40,40,40,02,02,02,02,02,40,40,43,40,40,40,40,40,40,40,40,40,40,40,40,40,40,02,02,02,02,02,02,02,02,02,02,40,40,40,40,40,40,40,40,40,40,02,02,02,02,02,02,00,00,00,00,00,00,00
00,00,00,00,00,00,00,02,40,40,40,40,40,40,40,40,40,40,40,02,02,02,02,02,40,40,40,40,40,40,40,40,40,40,43,40,40,40,40,40,40,02,02,02,02,02,02,02,02,02,02,40,40,40,40,40,40,40,40,40,40,02,02,02,02,02,02,00,00,00,00,00,00,00
00,00,00,00,00,00,00,02,40,40,40,40,40,02,02,40,40,40,40,02,02,02,02,02,02,02,02,02,02,02,02,40,40,40,40,40,40,40,40,40,40,02,02,02,02,02,02,02,02,02,02,40,40,40,40,44,40,40,40,40,40,02,02,02,02,02,02,00,00,00,00,00,00,00
00,00,00,00,00,00,00,02,40,40,40,40,40,02,02,40,40,40,40,02,02,02,02,02,02,02,02,02,02,02,02,40,40,40,02,02,02,02,40,40,40,02,02,02,02,02,02,02,02,02,02,40,40,40,40,44,44,40,40,40,44,02,02,02,02,02,02,00,00,00,00,00,00,00
00,00,00,00,00,00,00,02,40,40,40,40,40,40,40,40,40,40,40,40,40,02,02,02,02,02,02,02,02,02,02,40,40,40,02,02,02,02,40,40,40,02,02,02,02,02,02,02,02,02,02,40,40,40,02,02,02,02,40,40,43,44,40,40,40,40,40,87,00,00,00,00,00,00
00,00,00,00,00,00,00,02,40,40,40,40,40,40,40,40,40,40,40,40,40,02,02,02,02,02,02,02,02,02,02,43,40,40,02,02,02,02,40,40,40,02,02,02,02,02,02,02,02,02,02,40,40,40,02,02,02,02,40,40,40,40,40,40,40,40,40,87,00,00,00,00,00,00
00,00,00,00,00,00,00,02,40,40,40,40,40,02,02,02,02,40,40,40,40,02,02,02,02,02,02,02,02,02,02,43,40,40,02,02,02,02,44,40,44,02,02,02,02,02,02,02,02,02,02,40,40,40,02,02,02,02,40,40,40,02,02,02,02,02,02,00,00,00,00,00,00,00
00,00,00,00,00,00,00,02,40,40,40,40,40,02,02,02,02,40,40,40,40,02,02,02,02,02,02,02,02,02,02,44,40,40,02,02,02,02,40,40,40,02,02,02,02,02,02,02,02,02,02,40,40,40,40,40,40,40,40,40,40,02,02,02,02,02,02,00,00,00,00,00,00,00
00,00,00,00,00,00,00,02,40,40,40,40,40,02,02,02,02,40,40,40,40,02,02,02,02,02,02,02,02,02,02,40,40,40,02,02,02,02,40,40,40,02,02,02,02,02,02,02,02,02,02,40,40,40,40,40,40,40,40,40,40,02,02,02,02,02,02,00,00,00,00,00,00,00
00,00,00,00,00,00,00,02,40,40,40,40,44,02,02,02,02,40,43,40,40,02,02,02,02,02,02,02,02,02,02,40,40,40,40,40,40,40,40,40,40,02,02,02,02,02,02,02,02,02,43,40,40,40,40,40,40,40,40,40,40,02,02,02,02,02,02,00,00,00,00,00,00,00
00,00,00,00,00,00,00,02,40,40,40,40,40,02,02,02,02,40,40,40,40,02,02,02,02,02,02,02,02,02,02,40,40,40,40,40,40,40,40,40,40,02,02,02,02,02,02,02,02,02,40,40,40,40,40,40,40,40,40,40,40,02,02,02,02,02,02,00,00,00,00,00,00,00
00,00,00,00,00,00,00,02,40,43,40,40,40,02,02,02,02,40,40,40,40,02,02,02,02,02,02,02,02,02,02,40,40,40,40,44,40,40,40,40,40,02,02,02,02,02,02,02,02,02,40,40,40,40,40,40,40,40,40,40,40,02,02,02,02,02,02,00,00,00,00,00,00,00
00,00,00,00,00,00,00,02,02,02,40,40,40,02,02,02,02,40,40,40,40,02,02,02,02,40,40,40,40,40,40,40,40,40,40,40,40,40,40,40,40,40,40,40,40,02,02,02,02,02,40,40,40,44,40,40,40,40,40,40,44,02,02,02,02,02,02,00,00,00,00,00,00,00
00,00,00,00,00,00,00,02,02,02,40,40,40,02,02,02,02,40,40,40,40,02,02,02,02,02,02,02,02,02,02,02,40,40,40,40,40,40,40,40,40,40,40,44,40,02,02,02,02,02,40,40,40,40,02,02,02,02,02,02,02,02,02,02,02,02,02,00,00,00,00,00,00,00
00,00,00,00,00,00,00,02,02,02,40,40,40,02,02,02,02,40,40,40,44,02,02,02,02,02,02,02,02,02,02,02,02,02,02,02,02,02,02,02,02,40,40,40,40,02,02,02,02,02,40,40,40,40,02,02,02,02,02,02,02,02,02,02,02,02,02,00,00,00,00,00,00,00
00,00,00,00,00,00,00,02,02,02,40,40,40,02,02,02,02,40,40,40,40,02,02,02,02,02,02,02,02,02,02,02,02,02,02,02,02,02,02,02,02,40,40,40,40,02,02,02,02,02,40,40,40,40,02,02,02,02,02,02,02,02,02,02,02,02,02,00,00,00,00,00,00,00
00,00,00,00,00,00,00,02,02,02,40,40,40,02,02,02,02,40,40,40,40,02,02,02,02,02,02,02,02,02,02,02,44,40,40,40,40,40,43,44,02,40,40,40,40,02,02,02,02,02,40,40,40,40,02,02,02,02,02,02,02,02,02,02,02,02,02,00,00,00,00,00,00,00
00,00,00,00,00,00,00,02,02,02,40,40,40,02,02,02,02,02,02,02,40,02,02,02,02,02,02,02,02,02,02,02,40,40,40,43,02,02,40,43,02,40,40,40,40,40,40,40,40,40,40,40,40,40,02,02,02,02,02,02,02,02,02,02,02,02,02,00,00,00,00,00,00,00
00,00,00,00,00,00,00,02,02,02,40,40,40,02,02,02,02,02,02,02,40,02,02,02,02,02,02,02,02,02,40,40,40,40,40,40,02,02,40,40,02,40,43,40,40,40,40,40,40,40,40,40,40,40,02,02,02,02,02,02,02,02,02,02,02,02,02,00,00,00,00,00,00,00
00,00,00,00,00,00,00,02,02,02,40,40,40,02,02,02,02,02,02,02,40,40,40,40,02,02,02,02,02,02,40,40,40,40,18,40,40,40,40,40,02,40,40,40,40,40,40,40,40,02,02,02,02,02,02,02,02,02,02,02,02,02,02,02,02,02,02,00,00,00,00,00,00,00
00,00,00,00,00,00,00,02,02,02,40,40,40,44,40,40,40,02,02,02,40,40,40,40,02,02,02,02,02,40,40,40,40,18,18,18,40,40,40,40,02,02,02,02,02,40,40,40,40,02,02,02,02,02,02,02,02,02,02,02,02,02,02,02,02,02,02,00,00,00,00,00,00,00
00,00,00,00,00,00,00,02,02,02,44,40,40,40,40,40,40,02,02,02,40,40,40,40,02,02,02,02,02,40,40,40,40,18,18,18,18,40,40,40,40,40,40,40,02,40,40,40,40,02,02,02,02,02,02,02,02,02,02,02,02,02,02,02,02,02,02,00,00,00,00,00,00,00
00,00,00,00,00,00,00,02,02,02,02,02,02,02,02,40,40,02,02,02,40,40,40,40,02,02,02,02,02,40,40,40,40,40,18,18,18,18,40,40,40,40,44,40,02,40,43,40,40,02,02,02,02,02,02,02,02,02,02,02,02,02,02,02,02,02,02,00,00,00,00,00,00,00
00,00,00,00,00,00,00,02,02,02,02,02,02,02,02,40,40,02,02,02,02,02,02,02,02,02,02,02,02,40,40,02,02,40,18,18,18,18,40,40,40,40,40,40,02,40,43,43,40,40,40,40,40,40,44,40,40,40,44,40,40,40,40,40,40,02,02,00,00,00,00,00,00,00
00,00,00,00,00,00,00,02,02,02,02,02,02,02,02,40,40,02,02,02,02,02,02,02,02,02,02,02,40,40,40,02,02,40,18,18,18,40,40,40,40,40,40,40,02,40,40,40,40,40,40,40,44,40,43,40,44,40,40,40,40,40,40,40,40,02,02,00,00,00,00,00,00,00
00,00,00,00,00,00,00,02,02,02,02,02,02,02,02,40,40,02,02,02,02,02,02,02,02,02,02,02,44,40,40,40,40,40,40,18,40,40,40,40,40,40,40,40,02,40,40,40,40,02,02,02,02,02,02,02,02,02,02,02,02,02,40,40,40,02,02,00,00,00,00,00,00,00
00,00,00,00,00,00,00,02,02,02,02,02,02,02,02,40,40,02,02,02,02,02,02,02,02,02,02,02,44,40,40,40,40,40,40,40,40,40,40,44,40,40,40,40,02,40,40,40,40,02,02,02,02,02,02,02,02,02,02,02,02,02,40,40,40,02,02,00,00,00,00,00,00,00
00,00,00,00,00,00,00,02,02,02,02,02,02,02,02,40,40,02,02,02,02,02,02,02,02,02,02,02,40,40,40,40,40,40,40,40,40,40,40,40,40,40,40,40,02,40,40,40,40,40,40,40,40,40,40,40,40,40,40,40,02,02,40,44,40,02,02,00,00,00,00,00,00,00
00,00,00,00,00,00,00,80,40,40,40,40,40,40,40,40,40,02,02,02,02,02,02,02,02,02,02,02,44,40,40,40,40,40,40,40,43,40,40,40,40,40,40,43,02,40,40,40,40,40,40,40,40,40,40,40,40,40,40,40,02,02,40,44,40,02,02,00,00,00,00,00,00,00
00,00,00,00,00,00,00,02,02,02,02,02,02,02,02,02,40,02,02,02,02,02,02,02,02,02,02,02,02,02,02,40,40,40,40,40,40,40,40,40,40,40,40,40,02,40,40,40,40,40,40,40,40,40,40,40,40,40,40,40,02,02,40,44,40,02,02,00,00,00,00,00,00,00
00,00,00,00,00,00,00,02,02,02,02,02,02,02,02,02,40,44,02,02,02,02,02,02,02,02,02,02,02,02,02,40,40,40,40,40,40,40,40,40,40,40,40,40,02,02,02,02,02,02,02,02,02,02,02,02,02,02,02,02,02,02,40,40,40,02,02,00,00,00,00,00,00,00
00,00,00,00,00,00,00,02,02,02,02,02,02,02,02,02,40,44,02,02,02,02,02,02,02,02,02,02,02,02,02,02,02,02,02,40,40,40,40,44,40,40,40,40,40,02,02,02,02,02,02,02,02,02,02,02,02,02,02,02,02,02,40,40,40,02,02,00,00,00,00,00,00,00
00,00,00,00,00,00,00,02,02,02,02,02,02,02,02,02,40,40,02,02,02,02,02,02,02,02,02,02,02,02,02,02,02,02,02,02,02,02,02,02,40,40,40,40,40,40,40,40,40,43,40,40,40,40,44,40,40,40,40,40,40,43,40,40,40,02,02,00,00,00,00,00,00,00
00,00,00,00,00,00,00,02,02,02,02,02,02,02,02,02,40,40,02,02,02,02,02,02,02,02,02,02,02,02,02,02,02,02,02,02,02,02,02,02,43,40,40,40,40,40,40,40,40,40,43,40,40,40,40,40,40,40,02,02,02,02,02,02,02,02,02,00,00,00,00,00,00,00
00,00,00,00,00,00,00,02,02,02,02,02,02,02,02,02,02,02,02,02,02,02,02,02,02,02,02,02,02,02,02,02,02,02,02,02,02,02,02,02,02,02,02,02,02,02,02,02,02,02,02,02,02,02,02,02,02,02,02,02,02,02,02,02,02,02,02,00,00,00,00,00,00,00
00,00,00,00,00,00,00,00,00,00,00,00,00,00,00,00,00,00,00,00,00,00,00,00,00,00,00,00,00,00,00,00,00,00,00,00,00,00,00,00,00,00,00,00,00,00,00,00,00,00,00,00,00,00,00,00,00,00,00,00,00,00,00,00,00,00,00,00,00,00,00,00,00,00
00,00,00,00,00,00,00,00,00,00,00,00,00,00,00,00,00,00,00,00,00,00,00,00,00,00,00,00,00,00,00,00,00,00,00,00,00,00,00,00,00,00,00,00,00,00,00,00,00,00,00,00,00,00,00,00,00,00,00,00,00,00,00,00,00,00,00,00,00,00,00,00,00,00
00,00,00,00,00,00,00,00,00,00,00,00,00,00,00,00,00,00,00,00,00,00,00,00,00,00,00,00,00,00,00,00,00,00,00,00,00,00,00,00,00,00,00,00,00,00,00,00,00,00,00,00,00,00,00,00,00,00,00,00,00,00,00,00,00,00,00,00,00,00,00,00,00,00
00,00,00,00,00,00,00,00,00,00,00,00,00,00,00,00,00,00,00,00,00,00,00,00,00,00,00,00,00,00,00,00,00,00,00,00,00,00,00,00,00,00,00,00,00,00,00,00,00,00,00,00,00,00,00,00,00,00,00,00,00,00,00,00,00,00,00,00,00,00,00,00,00,00