44,38
02,02,02,02,02,02,02,02,02,02,02,02,02,02,02,02,02,02,02,02,02,02,02,02,02,02,02,02,02,02,02,02,02,02,02,02,02,02,02,02,02,02,02,02
02,02,02,02,02,02,02,02,02,02,02,02,02,02,02,02,02,02,02,02,02,02,02,02,02,02,02,02,02,02,02,02,02,02,02,02,02,02,02,02,02,02,02,02
02,02,02,02,02,02,02,02,02,02,02,02,02,02,02,02,02,02,02,02,02,02,02,02,02,02,02,02,02,02,02,02,02,02,02,02,02,02,02,02,02,02,02,02
02,02,02,02,02,02,02,02,02,02,02,02,02,02,02,02,02,02,02,02,02,02,02,02,02,02,02,02,02,02,02,02,02,02,02,02,02,02,02,02,02,02,02,02
02,02,02,02,02,02,02,02,02,02,02,02,02,02,02,02,02,02,02,02,02,02,02,02,02,02,02,02,02,02,02,02,02,02,02,02,02,02,02,02,02,02,02,02
02,02,02,02,02,02,02,02,59,02,02,02,02,02,02,02,02,02,02,40,40,40,40,40,40,40,02,40,40,40,40,40,40,40,40,61,02,02,02,02,02,02,02,02
02,02,02,02,02,02,02,02,40,40,40,40,40,40,40,40,02,02,02,40,02,02,02,02,02,02,02,02,02,02,02,02,40,02,02,02,02,02,02,02,02,02,02,02
02,02,02,02,02,02,02,02,40,02,02,02,02,02,02,40,40,40,40,40,40,40,40,02,02,02,02,40,40,40,40,40,40,02,02,40,02,02,02,02,02,02,02,02
02,02,02,02,02,02,02,02,40,40,40,40,40,40,02,02,02,40,02,02,02,02,40,02,02,02,02,40,02,02,02,02,02,02,02,40,02,02,02,02,02,02,02,02
02,02,02,02,02,02,02,02,02,02,40,02,40,40,40,02,02,40,02,02,02,02,40,02,02,02,02,40,02,02,02,40,40,40,40,40,02,02,02,02,02,02,02,02
02,02,02,02,02,02,02,02,02,02,40,02,40,02,40,02,02,40,02,40,40,40,40,40,40,02,02,40,02,02,02,40,02,40,02,02,02,02,02,02,02,02,02,02
02,02,02,02,02,02,02,02,02,02,40,02,40,02,40,02,02,40,02,02,02,02,02,02,40,02,02,40,40,40,02,40,02,40,02,02,02,02,02,02,02,02,02,02
02,02,02,02,02,02,02,02,02,02,40,02,40,02,40,40,02,40,02,02,02,02,40,02,02,02,02,02,02,40,02,40,02,40,02,02,02,02,02,02,02,02,02,02
02,02,02,02,02,02,02,02,02,02,40,02,40,02,02,02,02,40,02,02,02,02,40,02,40,02,02,40,02,40,02,02,02,40,02,02,02,02,02,02,02,02,02,02
02,02,02,02,02,02,02,02,02,02,40,02,40,02,02,02,02,40,40,40,40,40,40,02,40,40,40,40,02,40,40,40,40,40,02,02,02,02,02,02,02,02,02,02
02,02,02,02,02,02,02,02,40,40,40,02,40,40,40,40,02,02,02,02,02,02,02,02,40,02,02,40,02,02,02,02,02,40,02,02,02,02,02,02,02,02,02,02
02,02,02,02,02,02,02,02,40,02,02,02,02,02,02,02,02,02,02,02,02,02,02,02,02,02,02,40,02,02,02,02,02,40,02,02,02,02,02,02,02,02,02,02
02,02,02,02,02,02,02,02,40,40,40,02,40,40,40,40,40,40,40,40,40,40,40,40,40,40,02,40,40,40,40,40,02,40,02,02,02,02,02,02,02,02,02,02
02,02,02,02,02,02,02,02,40,02,40,02,40,02,02,02,02,02,02,02,02,02,02,02,02,40,02,02,02,40,02,40,02,40,02,02,02,02,02,02,02,02,02,02
02,02,02,02,02,02,02,02,40,40,40,40,40,02,40,40,02,40,40,40,02,02,02,02,02,40,40,40,02,40,02,40,02,40,02,02,02,02,02,02,02,02,02,02
02,02,02,02,02,02,02,02,02,02,02,02,02,02,40,02,02,40,02,40,40,40,40,02,02,02,02,40,02,40,02,02,02,40,02,02,02,02,02,02,02,02,02,02
02,02,02,02,02,02,02,02,02,40,40,02,02,02,40,02,02,40,02,02,02,02,40,02,02,02,02,40,02,40,02,02,02,40,02,02,02,02,02,02,02,02,02,02
02,02,02,02,02,02,02,02,02,40,40,40,40,40,40,02,02,40,40,40,02,02,40,40,40,40,40,40,02,40,02,02,40,40,02,02,02,02,02,02,02,02,02,02
02,02,02,02,02,02,02,02,02,02,02,02,02,02,40,02,02,02,02,40,02,02,02,02,02,02,02,02,40,40,02,40,40,02,02,02,02,02,02,02,02,02,02,02
02,02,02,02,02,02,02,02,02,40,40,40,40,02,40,02,02,02,02,40,02,40,40,40,02,02,02,02,40,02,02,40,02,02,02,02,02,02,02,02,02,02,02,02
02,02,02,02,02,02,02,02,02,40,02,02,40,02,40,02,02,02,02,40,02,02,02,40,40,40,40,40,40,02,02,40,02,40,40,40,02,02,02,02,02,02,02,02
02,02,02,02,02,02,02,02,02,40,02,02,40,40,40,40,40,40,40,40,02,02,02,40,02,02,02,02,02,02,02,40,40,40,02,40,02,02,02,02,02,02,02,02
02,02,02,02,02,02,02,02,02,40,02,02,02,02,02,02,02,02,02,02,02,02,02,40,02,02,02,02,02,02,02,40,02,40,02,40,02,02,02,02,02,02,02,02
02,02,02,02,02,02,02,02,02,40,02,02,02,02,02,02,02,02,40,40,40,40,40,40,02,40,40,40,40,40,40,40,02,40,02,40,02,02,02,02,02,02,02,02
02,02,02,02,02,02,02,02,02,40,40,40,40,40,40,40,40,40,40,02,02,02,02,40,02,40,02,02,02,40,02,02,02,40,02,40,02,02,02,02,02,02,02,02
02,02,02,02,02,02,02,02,02,02,02,02,02,40,02,02,02,02,02,02,02,02,02,02,02,40,02,02,02,40,02,02,02,02,02,40,02,02,02,02,02,02,02,02
02,02,02,02,02,02,02,02,02,40,40,40,02,40,02,02,02,40,40,40,40,40,40,02,02,40,02,40,40,40,02,02,02,02,40,40,02,02,02,02,02,02,02,02
02,02,02,02,02,02,02,02,02,02,02,40,40,40,40,40,40,40,02,02,02,02,40,40,40,40,02,40,40,40,40,40,40,40,40,02,02,02,02,02,02,02,02,02
02,02,02,02,02,02,02,02,02,02,02,02,02,02,02,02,02,02,02,02,02,02,02,02,02,02,02,02,02,02,02,02,02,02,02,02,02,02,02,02,02,02,02,02
02,02,02,02,02,02,02,02,02,02,02,02,02,02,02,02,02,02,02,02,02,02,02,02,02,02,02,02,02,02,02,02,02,02,02,02,02,02,02,02,02,02,02,02
02,02,02,02,02,02,02,02,02,02,02,02,02,02,02,02,02,02,02,02,02,02,02,02,02,02,02,02,02,02,02,02,02,02,02,02,02,02,02,02,02,02,02,02
02,02,02,02,02,02,02,02,02,02,02,02,02,02,02,02,02,02,02,02,02,02,02,02,02,02,02,02,02,02,02,02,02,02,02,02,02,02,02,02,02,02,02,02
02,02,02,02,02,02,02,02,02,02,02,02,02,02,02,02,02,02,02,02,02,02,02,02,02,02,02,02,02,02,02,02,02,02,02,02,02,02,02,02,02,02,02,02