42,38
02,02,02,02,02,02,02,02,02,02,02,02,02,02,02,02,02,02,02,02,02,02,02,02,02,02,02,02,02,02,02,02,02,02,02,02,02,02,02,02,02,02
02,02,02,02,02,02,02,02,02,02,02,02,02,02,02,02,02,02,02,02,02,02,02,02,02,02,02,02,02,02,02,02,02,02,02,02,02,02,02,02,02,02
02,02,02,02,02,02,02,02,02,02,02,02,02,02,02,02,02,02,02,02,02,02,02,02,02,02,02,02,02,02,02,02,02,02,02,02,02,02,02,02,02,02
02,02,02,02,02,02,02,02,02,02,02,02,02,02,02,02,02,02,02,02,02,02,02,02,02,02,02,02,02,02,02,02,02,02,02,02,02,02,02,02,02,02
02,02,02,02,02,02,02,02,02,02,02,02,02,02,02,02,02,02,02,02,02,02,02,02,02,02,02,02,02,02,02,02,02,02,02,02,02,02,02,02,02,02
02,02,02,02,02,02,02,02,61,40,40,40,40,44,40,40,40,40,40,40,40,40,40,40,40,40,40,40,02,40,40,40,40,40,02,02,02,02,02,02,02,02
02,02,02,02,02,02,02,02,44,40,40,40,40,40,40,40,40,40,40,40,40,40,43,40,40,40,40,40,02,40,40,40,40,40,02,02,02,02,02,02,02,02
02,02,02,02,02,02,02,02,43,40,40,40,40,40,40,40,02,02,02,02,02,02,02,02,02,40,40,40,02,40,40,40,40,40,02,02,02,02,02,02,02,02
02,02,02,02,02,02,02,02,40,40,103,40,43,40,40,40,02,40,40,40,106,40,40,40,02,40,40,40,02,40,40,40,40,40,02,02,02,02,02,02,02,02
02,02,02,02,02,02,02,02,40,40,40,40,40,40,40,40,02,40,40,40,40,40,40,40,02,40,40,40,02,02,02,40,02,02,02,02,02,02,02,02,02,02
02,02,02,02,02,02,02,02,40,40,40,44,40,40,40,40,02,40,40,104,40,104,40,40,02,40,43,40,40,40,44,40,44,40,02,02,02,02,02,02,02,02
02,02,02,02,02,02,02,02,40,02,02,02,02,02,02,40,02,40,40,104,40,104,40,40,02,40,40,40,40,40,40,40,40,40,02,02,02,02,02,02,02,02
02,02,02,02,02,02,02,02,40,02,40,40,40,40,02,40,02,02,02,02,40,02,02,02,02,44,40,40,40,40,40,40,40,40,02,02,02,02,02,02,02,02
02,02,02,02,02,02,02,02,40,02,40,40,40,40,02,40,40,40,02,40,40,40,02,43,40,40,40,40,40,40,43,40,40,40,02,02,02,02,02,02,02,02
02,02,02,02,02,02,02,02,40,02,40,103,40,40,40,40,40,44,02,40,40,40,02,40,40,40,40,40,02,02,02,40,02,02,02,02,02,02,02,02,02,02
02,02,02,02,02,02,02,02,40,02,40,40,40,40,02,40,40,40,02,40,40,40,02,40,40,40,40,40,02,40,40,40,40,40,02,02,02,02,02,02,02,02
02,02,02,02,02,02,02,02,43,02,40,40,40,40,02,40,40,40,02,02,40,02,02,40,40,40,44,40,02,40,40,40,40,40,02,02,02,02,02,02,02,02
02,02,02,02,02,02,02,02,40,02,02,02,02,02,02,40,40,40,40,40,40,40,40,40,40,40,40,40,02,40,40,103,40,40,02,02,02,02,02,02,02,02
02,02,02,02,02,02,02,02,40,40,40,40,40,43,40,40,40,40,40,40,40,40,40,40,40,40,40,40,02,40,40,40,40,40,02,02,02,02,02,02,02,02
02,02,02,02,02,02,02,02,40,40,40,40,40,40,40,40,40,40,40,40,40,40,43,40,40,40,40,40,02,02,02,02,02,02,02,02,02,02,02,02,02,02
02,02,02,02,02,02,02,02,40,40,40,40,40,40,40,40,40,40,40,40,40,40,40,40,40,40,40,40,40,40,44,40,40,40,02,02,02,02,02,02,02,02
02,02,02,02,02,02,02,02,40,40,40,40,40,40,40,40,40,40,43,40,104,40,40,40,40,40,40,40,40,40,40,40,40,40,02,02,02,02,02,02,02,02
02,02,02,02,02,02,02,02,40,40,40,40,40,40,40,40,40,40,40,40,40,40,40,40,40,40,40,40,40,40,40,40,40,40,02,02,02,02,02,02,02,02
02,02,02,02,02,02,02,02,40,40,40,43,40,40,40,40,40,40,40,40,40,40,40,40,40,40,44,40,40,40,40,40,40,40,02,02,02,02,02,02,02,02
02,02,02,02,02,02,02,02,40,40,40,40,02,02,02,02,02,02,02,40,40,40,40,40,40,40,40,40,40,40,40,40,40,40,02,02,02,02,02,02,02,02
02,02,02,02,02,02,02,02,40,40,40,40,02,40,40,40,40,40,02,40,40,40,40,40,40,40,40,40,40,40,40,40,40,40,02,02,02,02,02,02,02,02
02,02,02,02,02,02,02,02,40,44,40,40,02,105,40,40,40,40,02,40,40,40,40,40,40,40,40,40,40,40,40,40,40,44,02,02,02,02,02,02,02,02
02,02,02,02,02,02,02,02,44,44,43,40,02,40,40,40,40,40,40,40,40,40,40,43,43,40,40,40,02,02,02,02,40,44,02,02,02,02,02,02,02,02
02,02,02,02,02,02,02,02,44,43,40,40,02,40,40,40,40,40,02,40,40,40,40,40,40,40,40,40,02,40,40,02,40,40,02,02,02,02,02,02,02,02
02,02,02,02,02,02,02,02,40,40,40,40,02,02,02,02,02,02,02,44,40,40,40,40,40,40,40,40,02,104,40,40,40,40,02,02,02,02,02,02,02,02
02,02,02,02,02,02,02,02,40,40,40,40,40,43,40,40,40,40,40,40,40,40,40,40,40,40,40,40,02,40,40,02,40,40,02,02,02,02,02,02,02,02
02,02,02,02,02,02,02,02,40,40,40,40,40,40,40,40,40,40,40,40,40,40,40,40,40,103,40,40,02,02,02,02,43,44,02,02,02,02,02,02,02,02
02,02,02,02,02,02,02,02,40,40,40,40,40,40,40,40,40,40,44,40,40,40,40,40,40,40,40,40,40,40,40,44,43,59,02,02,02,02,02,02,02,02
02,02,02,02,02,02,02,02,02,02,02,02,02,02,02,02,02,02,02,02,02,02,02,02,02,02,02,02,02,02,02,02,02,02,02,02,02,02,02,02,02,02
02,02,02,02,02,02,02,02,02,02,02,02,02,02,02,02,02,02,02,02,02,02,02,02,02,02,02,02,02,02,02,02,02,02,02,02,02,02,02,02,02,02
02,02,02,02,02,02,02,02,02,02,02,02,02,02,02,02,02,02,02,02,02,02,02,02,02,02,02,02,02,02,02,02,02,02,02,02,02,02,02,02,02,02
02,02,02,02,02,02,02,02,02,02,02,02,02,02,02,02,02,02,02,02,02,02,02,02,02,02,02,02,02,02,02,02,02,02,02,02,02,02,02,02,02,02
02,02,02,02,02,02,02,02,02,02,02,02,02,02,02,02,02,02,02,02,02,02,02,02,02,02,02,02,02,02,02,02,02,02,02,02,02,02,02,02,02,02