49,40
97,97,97,97,97,97,97,97,97,97,97,97,97,97,97,97,97,97,97,97,97,97,97,97,97,97,97,97,97,97,97,97,97,97,97,97,97,97,97,97,97,97,97,97,97,97,97,97,97
97,97,97,97,97,97,97,97,97,97,97,97,97,97,97,97,97,97,97,97,97,97,97,97,97,97,97,97,97,97,97,97,97,97,97,97,97,97,97,97,97,97,97,97,97,97,97,97,97
97,97,97,97,97,97,97,97,97,97,97,97,97,97,97,97,97,97,97,97,97,97,97,97,97,97,97,97,97,97,97,97,97,97,97,97,97,97,97,97,97,97,97,97,97,97,97,97,97
97,97,97,97,97,97,97,97,97,97,97,97,97,97,97,97,97,97,97,97,97,97,97,97,97,97,97,97,97,97,97,97,97,97,97,97,97,97,97,97,97,97,97,97,97,97,97,97,97
97,97,97,97,97,97,97,97,97,97,97,97,97,97,97,97,97,97,97,97,97,97,97,97,97,97,97,97,97,97,97,97,97,97,97,97,97,97,97,97,97,97,97,97,97,97,97,97,97
97,97,97,97,97,97,97,97,97,97,97,97,97,97,97,97,97,97,97,97,97,97,97,97,97,97,97,97,97,97,97,97,90,90,90,90,90,90,90,90,97,97,97,97,97,97,97,97,97
97,97,97,97,97,97,97,90,90,90,90,90,90,90,90,97,97,97,97,97,97,97,97,97,97,97,97,97,97,97,97,97,90,28,28,28,28,32,28,90,97,97,97,97,97,97,97,97,97
97,97,97,97,97,97,97,90,33,33,33,33,33,33,90,97,97,97,97,97,97,97,97,97,97,97,97,97,97,97,97,97,90,28,28,28,28,32,28,90,97,97,97,97,97,97,97,97,97
97,97,97,97,97,97,97,90,28,28,28,28,28,28,90,97,97,97,97,97,97,97,97,97,97,97,97,97,97,97,97,97,90,28,28,28,28,55,45,90,97,97,97,97,97,97,97,97,97
97,97,97,97,97,97,97,90,38,28,28,28,28,28,27,27,27,27,27,27,27,27,27,27,27,27,27,27,27,27,27,27,27,28,108,28,28,32,28,90,97,97,97,97,97,97,97,97,97
97,97,97,97,97,97,97,90,39,28,28,28,28,28,90,97,97,97,97,97,97,97,97,97,27,27,97,97,97,97,97,97,90,28,28,28,28,32,28,90,97,97,97,97,97,97,97,97,97
97,97,97,97,97,97,97,90,28,36,37,28,36,37,90,97,97,97,97,97,97,97,97,97,27,27,97,97,97,97,97,97,90,90,90,90,90,90,90,90,97,97,97,97,97,97,97,97,97
97,97,97,97,97,97,97,90,90,90,90,90,90,90,90,97,97,97,97,97,97,97,97,97,27,27,97,97,97,97,97,97,97,97,97,97,97,97,97,97,97,97,97,97,97,97,97,97,97
97,97,97,97,97,97,97,97,97,97,97,97,97,97,97,97,97,97,97,97,97,97,97,97,27,27,97,97,97,97,97,97,97,97,97,97,97,97,97,97,97,97,97,97,97,97,97,97,97
97,97,97,97,97,97,97,97,97,97,90,90,90,90,90,90,90,97,97,97,97,97,97,97,27,27,97,97,97,97,97,97,97,97,97,97,97,97,97,97,97,97,97,97,97,97,97,97,97
97,97,97,97,97,97,97,97,97,97,90,28,36,37,28,28,90,97,97,97,97,97,97,97,27,27,97,97,97,97,97,97,97,97,97,97,97,97,97,97,97,97,97,97,97,97,97,97,97
97,97,97,97,97,97,97,97,97,97,90,28,28,28,28,28,90,97,27,27,27,27,27,27,27,27,27,27,27,27,27,27,97,97,97,97,97,97,97,97,97,97,97,97,97,97,97,97,97
97,97,97,97,97,97,97,97,97,97,90,28,108,28,28,28,90,97,27,97,97,97,97,97,27,27,97,97,97,97,97,27,97,97,97,97,97,97,97,97,97,97,97,97,97,97,97,97,97
97,97,97,97,97,97,97,97,97,97,90,28,28,28,28,100,90,97,27,97,90,90,90,90,27,27,90,90,90,90,97,27,97,97,97,97,97,97,97,97,97,97,97,97,97,97,97,97,97
97,97,97,97,97,97,97,97,97,97,90,90,90,27,90,90,90,97,27,97,90,112,112,33,28,28,33,112,113,90,97,27,97,97,97,97,97,97,97,97,97,97,97,97,97,97,97,97,97
97,97,97,97,97,97,97,97,97,97,97,97,97,27,97,97,97,97,27,97,90,28,28,28,28,28,28,28,28,90,97,27,97,97,97,97,97,97,97,97,97,97,97,97,97,97,97,97,97
97,97,97,97,97,97,97,97,97,97,97,97,97,27,97,97,97,97,27,97,90,28,28,28,28,28,28,28,28,90,97,27,97,97,97,97,90,90,90,90,90,97,97,97,97,97,97,97,97
97,97,97,97,97,97,97,97,97,97,97,97,97,27,97,97,97,97,27,97,90,28,28,28,28,28,28,28,110,90,97,27,97,97,97,97,90,28,32,28,90,97,97,97,97,97,97,97,97
97,97,97,97,97,97,97,97,97,97,97,97,97,27,27,27,27,27,27,27,27,28,28,28,28,28,28,28,28,27,27,27,27,27,27,27,27,28,53,45,90,97,97,97,97,97,97,97,97
97,97,97,97,97,97,97,97,97,97,97,97,97,27,97,97,97,97,27,97,90,32,28,28,28,28,28,28,32,90,97,27,97,97,97,97,90,28,32,28,90,97,97,97,97,97,97,97,97
97,97,97,97,97,97,97,97,97,97,97,97,97,27,97,97,97,97,27,97,90,115,28,28,111,28,28,28,114,90,97,27,97,97,97,97,90,90,90,90,90,97,97,97,97,97,97,97,97
97,97,97,97,97,97,97,97,97,97,97,97,97,27,97,97,97,97,27,97,90,114,28,28,28,28,28,28,115,90,97,27,97,97,97,97,97,97,97,97,97,97,97,97,97,97,97,97,97
97,97,97,97,97,97,97,97,97,97,90,90,90,27,90,90,90,97,27,97,90,34,33,112,28,28,113,33,35,90,97,27,97,97,97,97,97,97,97,97,97,97,97,97,97,97,97,97,97
97,97,97,97,97,97,97,97,97,97,90,100,28,28,28,28,90,97,27,97,90,90,90,90,27,27,90,90,90,90,97,27,97,97,97,97,97,97,97,97,97,97,97,97,97,97,97,97,97
97,97,97,97,97,97,97,97,97,97,90,60,28,28,28,28,90,97,27,97,97,97,97,97,27,27,97,97,97,97,97,27,97,97,97,97,97,97,97,97,97,97,97,97,97,97,97,97,97
97,97,97,97,97,97,97,97,97,97,90,28,28,109,28,28,90,97,27,27,27,27,27,27,27,27,27,27,27,27,27,27,97,97,97,97,97,97,97,97,97,97,97,97,97,97,97,97,97
97,97,97,97,97,97,97,97,97,97,90,100,36,37,28,99,90,97,97,97,97,97,97,97,27,27,97,97,97,97,97,97,97,97,97,97,97,97,97,97,97,97,97,97,97,97,97,97,97
97,97,97,97,97,97,97,97,97,97,90,90,90,90,90,90,90,97,97,97,97,97,97,97,27,27,97,97,97,97,97,97,97,97,97,97,97,97,97,97,97,97,97,97,97,97,97,97,97
97,97,97,97,97,97,97,97,97,97,97,97,97,97,97,97,97,97,97,97,97,97,97,97,27,27,97,97,97,97,97,97,97,97,97,97,97,97,97,97,97,97,97,97,97,97,97,97,97
97,97,97,97,97,97,97,97,97,97,97,97,97,97,97,97,97,97,97,97,97,97,97,97,27,27,97,97,97,97,97,97,97,97,97,97,97,97,97,97,97,97,97,97,97,97,97,97,97
97,97,97,97,97,97,97,97,97,97,97,97,97,97,97,97,97,97,97,97,97,97,97,97,129,129,97,97,97,97,97,97,97,97,97,97,97,97,97,97,97,97,97,97,97,97,97,97,97
97,97,97,97,97,97,97,97,97,97,97,97,97,97,97,97,97,97,97,97,97,97,97,97,97,97,97,97,97,97,97,97,97,97,97,97,97,97,97,97,97,97,97,97,97,97,97,97,97
97,97,97,97,97,97,97,97,97,97,97,97,97,97,97,97,97,97,97,97,97,97,97,97,97,97,97,97,97,97,97,97,97,97,97,97,97,97,97,97,97,97,97,97,97,97,97,97,97
97,97,97,97,97,97,97,97,97,97,97,97,97,97,97,97,97,97,97,97,97,97,97,97,97,97,97,97,97,97,97,97,97,97,97,97,97,97,97,97,97,97,97,97,97,97,97,97,97
97,97,97,97,97,97,97,97,97,97,97,97,97,97,97,97,97,97,97,97,97,97,97,97,97,97,97,97,97,97,97,97,97,97,97,97,97,97,97,97,97,97,97,97,97,97,97,97,97