56,51
00,00,00,00,00,00,00,00,00,00,00,00,00,00,00,00,00,00,00,00,00,00,00,00,00,00,00,00,00,00,00,00,00,00,00,00,00,00,00,00,00,00,00,00,00,00,00,00,00,00,00,00,00,00,00,00
00,00,00,00,00,00,00,00,00,00,00,00,00,00,00,00,00,00,00,00,00,00,00,00,00,00,00,00,00,00,00,00,00,00,00,00,00,00,00,00,00,00,00,00,00,00,00,00,00,00,00,00,00,00,00,00
00,00,00,00,00,00,00,00,00,00,00,00,00,00,00,00,00,00,00,00,00,00,00,00,00,00,00,00,00,00,00,00,00,00,00,00,00,00,00,00,00,00,00,00,00,00,00,00,00,00,00,00,00,00,00,00
00,00,00,00,00,00,00,00,00,00,00,00,00,00,00,00,00,00,00,00,00,00,00,00,00,00,00,00,00,00,00,00,00,00,00,00,00,00,00,00,00,00,00,00,00,00,00,00,00,00,00,00,00,00,00,00
00,00,00,00,00,00,00,29,29,29,29,29,29,29,29,29,29,01,01,01,01,01,01,01,01,01,01,01,01,01,01,01,01,01,01,01,01,01,01,29,29,29,29,29,29,29,29,29,29,00,00,00,00,00,00,00
00,00,00,00,00,00,00,29,67,28,28,28,28,28,28,28,29,03,01,01,01,01,01,01,01,01,01,01,01,01,01,01,01,01,01,01,01,01,01,29,28,28,28,28,28,28,28,28,29,00,00,00,00,00,00,00
00,00,00,00,00,00,00,29,28,28,28,28,28,28,28,28,29,84,01,01,01,01,01,01,01,01,01,01,84,84,01,01,01,01,01,84,01,01,01,29,28,28,67,28,28,28,28,28,29,00,00,00,00,00,00,00
00,00,00,00,00,00,00,29,28,28,28,28,28,28,28,28,29,29,29,29,29,29,29,29,29,29,29,29,29,29,29,29,29,29,29,29,29,29,29,29,28,28,28,28,28,28,28,28,29,00,00,00,00,00,00,00
00,00,00,00,00,00,00,29,28,28,28,28,28,28,28,28,28,28,28,28,28,28,28,28,28,28,28,28,28,28,28,28,28,28,28,28,28,28,28,28,28,28,28,28,28,101,28,28,29,00,00,00,00,00,00,00
00,00,00,00,00,00,00,29,28,28,28,28,29,29,29,29,29,29,29,29,29,29,29,29,29,29,29,29,29,29,29,29,29,29,29,29,29,29,29,29,29,29,29,29,28,28,28,28,29,00,00,00,00,00,00,00
00,00,00,00,00,00,00,29,28,28,28,28,29,99,100,28,28,28,28,28,28,28,28,28,28,28,28,121,28,28,28,28,28,28,28,29,28,28,28,28,28,28,28,29,28,28,28,28,29,00,00,00,00,00,00,00
00,00,00,00,00,00,00,29,28,28,28,28,29,28,28,28,28,28,28,28,29,28,28,28,28,28,28,28,28,28,67,28,28,28,28,29,28,28,28,28,28,28,28,29,28,28,28,28,29,00,00,00,00,00,00,00
00,00,00,00,00,00,00,29,28,28,28,28,29,38,28,28,28,28,28,28,29,28,28,28,28,28,28,28,28,28,28,28,28,28,28,64,28,28,28,28,28,28,28,29,28,28,28,28,29,00,00,00,00,00,00,00
00,00,00,00,00,00,00,29,29,29,29,28,29,39,28,28,28,28,28,28,29,28,28,28,63,28,28,28,28,28,28,28,28,28,28,29,28,28,28,28,28,28,28,29,28,29,29,29,29,00,00,00,00,00,00,00
00,00,00,00,00,00,00,01,84,03,29,28,29,28,28,28,28,28,28,28,29,28,28,28,28,28,28,28,28,28,28,28,28,28,28,29,28,28,28,28,28,28,28,29,28,29,85,01,01,00,00,00,00,00,00,00
00,00,00,00,00,00,00,01,01,84,29,28,29,28,28,36,37,28,28,99,29,28,28,28,28,28,28,28,28,28,28,28,28,28,28,29,28,28,28,28,28,28,28,29,28,29,01,01,01,00,00,00,00,00,00,00
00,00,00,00,00,00,00,01,01,01,29,28,29,29,29,29,29,29,29,29,29,29,29,29,29,29,28,28,28,28,29,29,29,29,29,29,29,29,29,29,29,29,29,29,28,29,84,01,01,00,00,00,00,00,00,00
00,00,00,00,00,00,00,01,84,01,29,28,29,28,28,28,28,28,28,29,03,01,03,01,03,01,01,01,01,01,01,03,01,03,01,03,29,36,37,28,28,100,99,29,28,29,84,01,01,00,00,00,00,00,00,00
00,00,00,00,00,00,00,01,01,85,29,28,29,28,28,36,37,28,28,29,01,01,01,01,01,01,01,01,01,01,01,01,01,01,01,01,29,28,28,28,28,28,28,29,28,29,84,01,01,00,00,00,00,00,00,00
00,00,00,00,00,00,00,01,01,01,29,28,29,28,28,28,28,28,28,29,03,01,01,01,01,01,84,21,21,84,01,01,01,01,01,03,29,28,28,67,28,100,99,29,28,29,01,03,01,00,00,00,00,00,00,00
00,00,00,00,00,00,00,01,01,03,29,28,29,36,37,28,74,28,28,01,01,01,01,01,01,84,26,18,18,25,84,01,01,01,01,01,01,28,28,28,28,28,28,29,28,29,01,01,85,00,00,00,00,00,00,00
00,00,00,00,00,00,00,01,01,84,29,28,29,28,28,28,28,28,28,29,03,01,01,01,01,22,18,18,18,18,20,01,01,01,01,03,29,28,67,28,28,100,99,29,28,29,01,01,01,00,00,00,00,00,00,00
00,00,00,00,00,00,00,85,01,01,29,28,29,28,28,36,37,28,28,29,01,01,01,01,01,22,18,18,18,18,20,01,01,01,01,01,29,28,28,28,28,28,28,29,28,29,01,01,01,00,00,00,00,00,00,00
00,00,00,00,00,00,00,01,01,84,29,28,29,28,28,28,28,28,28,29,03,01,48,01,01,84,23,18,18,24,84,01,01,01,01,03,29,36,37,28,28,100,99,29,28,29,01,84,01,00,00,00,00,00,00,00
00,00,00,00,00,00,00,01,01,01,29,28,29,29,29,29,28,29,29,29,01,01,01,01,01,01,84,19,19,84,01,01,01,01,01,01,29,29,29,28,29,29,29,29,28,29,03,01,01,00,00,00,00,00,00,00
00,00,00,00,00,00,00,01,01,01,29,28,28,28,28,28,28,28,28,29,03,01,03,01,03,01,01,01,01,01,01,03,01,03,01,03,29,28,28,28,28,28,28,29,28,29,01,01,01,00,00,00,00,00,00,00
00,00,00,00,00,00,00,01,01,01,29,28,29,29,29,29,29,29,28,29,29,29,29,29,29,29,28,28,28,28,29,29,29,29,29,29,29,28,29,29,29,29,29,29,28,29,01,01,03,00,00,00,00,00,00,00
00,00,00,00,00,00,00,01,01,85,29,28,29,28,28,45,28,29,28,28,28,28,28,28,28,28,28,28,28,28,28,28,28,28,28,28,28,28,29,28,45,28,28,29,28,29,84,01,01,00,00,00,00,00,00,00
00,00,00,00,00,00,00,01,01,01,29,28,29,33,33,66,33,29,29,29,29,29,29,29,29,29,29,28,28,29,29,29,29,29,29,29,29,29,29,33,70,33,33,29,28,29,01,01,01,00,00,00,00,00,00,00
00,00,00,00,00,00,00,03,01,84,29,28,29,28,28,28,28,28,36,37,29,99,28,28,28,99,29,28,28,29,99,28,28,28,99,29,36,37,28,28,28,28,28,29,28,29,84,84,01,00,00,00,00,00,00,00
00,00,00,00,00,00,00,01,01,01,29,28,29,28,28,28,28,28,28,28,29,28,28,101,28,28,29,28,28,29,28,28,28,28,28,29,28,28,28,28,28,28,28,29,28,29,84,01,01,00,00,00,00,00,00,00
00,00,00,00,00,00,00,01,01,01,29,28,29,28,28,28,28,28,28,28,29,28,28,28,28,28,29,28,28,29,28,28,28,28,28,29,28,28,28,28,28,28,28,29,28,29,85,01,01,00,00,00,00,00,00,00
00,00,00,00,00,00,00,01,01,01,29,28,29,29,29,29,28,29,29,29,29,29,29,28,29,29,29,28,28,29,29,29,28,29,29,29,29,29,29,28,29,29,29,29,28,29,01,01,01,00,00,00,00,00,00,00
00,00,00,00,00,00,00,84,01,01,29,28,29,28,28,28,28,28,28,28,28,28,28,28,28,28,28,28,28,28,28,28,28,28,28,28,28,28,28,28,28,28,28,29,28,29,01,01,01,00,00,00,00,00,00,00
00,00,00,00,00,00,00,01,01,01,29,28,29,29,29,29,28,29,29,29,28,29,29,29,28,28,28,28,28,28,28,28,29,29,29,28,29,29,29,28,29,29,29,29,28,29,01,01,01,00,00,00,00,00,00,00
00,00,00,00,00,00,00,03,01,03,29,28,29,28,28,28,28,28,29,28,28,28,99,29,28,28,28,28,28,28,28,28,29,100,28,28,99,29,28,28,28,28,28,29,28,29,85,01,01,00,00,00,00,00,00,00
00,00,00,00,00,00,00,29,29,29,29,28,29,38,28,28,28,28,29,28,28,28,28,29,28,28,28,28,28,28,28,28,29,28,28,28,28,29,28,28,28,28,38,29,28,29,29,29,29,00,00,00,00,00,00,00
00,00,00,00,00,00,00,29,28,28,28,28,29,39,28,28,28,28,29,28,28,28,28,29,28,28,28,28,28,28,28,28,29,28,101,28,28,29,28,28,28,28,39,29,28,28,28,28,29,00,00,00,00,00,00,00
00,00,00,00,00,00,00,29,28,28,28,28,29,28,28,28,28,28,29,28,28,28,28,29,29,29,28,28,28,28,28,28,29,28,28,28,28,29,28,28,99,100,28,29,28,28,28,28,29,00,00,00,00,00,00,00
00,00,00,00,00,00,00,29,28,67,28,28,29,100,28,28,28,99,29,100,36,37,28,29,45,53,28,28,28,28,28,28,29,28,36,37,28,29,28,28,28,28,28,29,28,28,28,28,29,00,00,00,00,00,00,00
00,00,00,00,00,00,00,29,28,28,28,28,29,29,29,29,29,29,29,29,29,29,29,29,29,29,28,28,28,28,28,28,29,29,29,29,29,29,29,29,29,29,29,29,28,45,28,28,29,00,00,00,00,00,00,00
00,00,00,00,00,00,00,29,28,28,28,28,28,28,28,28,28,28,28,28,28,28,28,28,28,28,28,28,28,28,28,28,28,28,28,28,28,28,28,28,28,28,28,28,28,28,28,28,29,00,00,00,00,00,00,00
00,00,00,00,00,00,00,29,28,28,28,28,28,28,28,28,29,29,29,29,29,29,29,29,29,29,28,28,28,28,29,29,29,29,29,29,29,29,29,29,28,28,28,67,28,28,28,28,29,00,00,00,00,00,00,00
00,00,00,00,00,00,00,29,28,28,28,28,67,28,28,28,29,03,01,01,84,01,84,85,01,01,88,88,88,88,01,01,01,85,01,03,01,01,01,29,28,28,28,28,28,28,28,28,29,00,00,00,00,00,00,00
00,00,00,00,00,00,00,29,28,28,28,28,28,28,28,28,29,01,01,01,01,01,01,01,01,84,102,88,88,88,01,03,01,01,01,01,01,01,01,29,28,28,28,28,28,28,28,28,29,00,00,00,00,00,00,00
00,00,00,00,00,00,00,29,29,29,29,29,29,29,29,29,29,85,01,01,01,01,01,01,01,01,88,88,88,88,01,01,01,01,01,01,01,84,01,29,29,29,29,29,29,29,29,29,29,00,00,00,00,00,00,00
00,00,00,00,00,00,00,00,00,00,00,00,00,00,00,00,00,00,00,00,00,00,00,00,00,00,87,87,87,87,00,00,00,00,00,00,00,00,00,00,00,00,00,00,00,00,00,00,00,00,00,00,00,00,00,00
00,00,00,00,00,00,00,00,00,00,00,00,00,00,00,00,00,00,00,00,00,00,00,00,00,00,00,00,00,00,00,00,00,00,00,00,00,00,00,00,00,00,00,00,00,00,00,00,00,00,00,00,00,00,00,00
00,00,00,00,00,00,00,00,00,00,00,00,00,00,00,00,00,00,00,00,00,00,00,00,00,00,00,00,00,00,00,00,00,00,00,00,00,00,00,00,00,00,00,00,00,00,00,00,00,00,00,00,00,00,00,00
00,00,00,00,00,00,00,00,00,00,00,00,00,00,00,00,00,00,00,00,00,00,00,00,00,00,00,00,00,00,00,00,00,00,00,00,00,00,00,00,00,00,00,00,00,00,00,00,00,00,00,00,00,00,00,00
00,00,00,00,00,00,00,00,00,00,00,00,00,00,00,00,00,00,00,00,00,00,00,00,00,00,00,00,00,00,00,00,00,00,00,00,00,00,00,00,00,00,00,00,00,00,00,00,00,00,00,00,00,00,00,00