25,16
00,00,00,00,00,00,00,00,00,00,00,00,00,00,00,00,00,00,00,00,00,00,00,00,00
00,00,00,00,00,00,00,00,00,00,00,00,00,00,00,00,00,00,00,00,00,00,00,00,00
00,00,00,00,00,00,00,00,00,00,00,00,00,00,00,00,00,00,00,00,00,00,00,00,00
00,00,00,00,00,00,00,00,00,00,00,00,00,00,00,00,00,00,00,00,00,00,00,00,00
00,00,00,00,00,00,00,29,29,29,29,29,29,29,29,29,29,29,00,00,00,00,00,00,00
00,00,00,00,00,00,00,29,28,28,28,28,28,28,28,28,28,29,00,00,00,00,00,00,00
00,00,00,00,00,00,00,29,28,28,28,28,28,28,28,28,28,29,00,00,00,00,00,00,00
00,00,00,00,00,00,00,29,28,28,28,128,28,127,28,28,28,29,00,00,00,00,00,00,00
00,00,00,00,00,00,00,29,38,28,28,28,28,28,28,28,28,29,00,00,00,00,00,00,00
00,00,00,00,00,00,00,29,39,28,28,28,28,28,28,28,28,29,00,00,00,00,00,00,00
00,00,00,00,00,00,00,29,28,28,28,28,28,28,28,36,37,29,00,00,00,00,00,00,00
00,00,00,00,00,00,00,29,29,29,29,29,61,29,29,29,29,29,00,00,00,00,00,00,00
00,00,00,00,00,00,00,00,00,00,00,00,00,00,00,00,00,00,00,00,00,00,00,00,00
00,00,00,00,00,00,00,00,00,00,00,00,00,00,00,00,00,00,00,00,00,00,00,00,00
00,00,00,00,00,00,00,00,00,00,00,00,00,00,00,00,00,00,00,00,00,00,00,00,00
00,00,00,00,00,00,00,00,00,00,00,00,00,00,00,00,00,00,00,00,00,00,00,00,00