40,37
00,00,00,00,00,00,00,00,00,00,00,00,00,00,00,00,00,00,00,00,00,00,00,00,00,00,00,00,00,00,00,00,00,00,00,00,00,00,00,00
00,00,00,00,00,00,00,00,00,00,00,00,00,00,00,00,00,00,00,00,00,00,00,00,00,00,00,00,00,00,00,00,00,00,00,00,00,00,00,00
00,00,00,00,00,00,00,00,00,00,00,00,00,00,00,00,00,00,00,00,00,00,00,00,00,00,00,00,00,00,00,00,00,00,00,00,00,00,00,00
00,00,00,00,00,00,00,00,00,00,00,00,00,00,00,00,00,00,00,00,00,00,00,00,00,00,00,00,00,00,00,00,00,00,00,00,00,00,00,00
00,00,00,00,00,00,00,87,87,87,87,87,87,87,87,87,87,87,87,87,87,87,87,87,87,87,87,87,87,87,87,18,18,18,18,18,18,18,18,18
00,00,00,00,00,00,00,87,01,01,01,01,01,01,01,01,01,01,01,01,01,01,01,01,01,01,01,01,01,01,22,18,18,18,18,18,18,18,18,18
00,00,00,00,00,00,00,87,01,57,57,57,57,57,01,01,01,01,01,84,01,01,01,01,01,01,01,01,01,01,22,18,18,18,18,18,18,18,18,18
00,00,00,00,00,00,00,87,01,57,40,40,40,57,01,01,01,01,01,01,01,01,01,01,01,01,01,01,01,01,01,23,18,18,18,18,18,18,18,18
00,00,00,00,00,00,00,87,01,57,72,40,40,40,40,40,40,01,01,01,01,01,01,03,50,01,01,01,01,01,01,22,18,18,18,18,18,18,18,18
00,00,00,00,00,00,00,87,01,57,40,40,40,57,01,01,40,40,40,01,01,01,01,01,01,01,01,01,01,01,01,26,18,18,18,18,18,18,18,18
00,00,00,00,00,00,00,87,01,57,57,57,57,57,01,01,01,01,40,01,01,01,01,01,01,01,01,03,01,01,22,18,18,18,18,18,18,18,18,18
00,00,00,00,00,00,00,87,82,83,82,83,82,83,82,83,82,83,40,01,01,01,01,01,01,01,57,57,57,01,22,18,18,18,18,18,18,18,18,18
00,00,00,00,00,00,00,87,83,82,83,82,83,82,83,82,83,82,40,01,01,01,01,01,01,01,57,45,57,01,22,18,18,18,18,18,18,18,18,18
00,00,00,00,00,00,00,87,82,83,82,83,82,83,82,83,82,83,40,01,01,01,01,57,57,57,57,69,57,01,01,23,18,18,18,18,18,18,18,18
00,00,00,00,00,00,00,87,83,82,83,82,83,82,83,82,83,82,40,40,40,40,40,40,28,28,28,28,57,01,01,22,18,18,18,18,18,18,18,18
00,00,00,00,00,00,00,87,82,83,82,83,82,83,82,83,82,83,40,01,01,01,01,57,28,28,28,28,57,01,01,22,18,18,18,18,18,18,18,18
00,00,00,00,00,00,00,87,83,82,83,82,83,82,83,82,83,82,40,03,01,01,01,57,57,57,57,28,57,01,01,22,18,18,18,18,18,18,18,18
00,00,00,00,00,00,00,87,82,83,82,83,82,83,82,83,82,83,40,01,01,01,01,57,28,28,57,28,57,01,01,22,18,18,18,18,18,18,18,18
00,00,00,00,00,00,00,87,83,82,83,82,83,82,83,82,83,82,40,01,01,01,01,57,28,28,28,28,57,01,01,22,18,18,18,18,18,18,18,18
00,00,00,00,00,00,00,87,82,83,82,83,82,83,82,83,82,83,40,01,01,01,03,57,57,57,57,57,57,01,01,22,18,18,18,18,18,18,18,18
00,00,00,00,00,00,00,87,83,82,83,82,83,82,83,82,83,82,40,48,01,01,01,01,01,01,01,01,01,01,01,26,18,18,18,18,18,18,18,18
00,00,00,00,00,00,00,87,40,40,40,40,40,40,40,40,40,40,40,40,40,40,40,40,40,40,40,40,40,40,40,88,88,18,18,18,18,18,18,18
00,00,00,00,00,00,00,87,40,40,40,40,40,40,40,40,40,40,40,40,40,40,40,40,40,40,40,40,40,40,40,88,98,18,18,18,18,18,18,18
00,00,00,00,00,00,00,87,01,01,01,01,01,01,01,40,83,83,83,83,83,83,83,83,83,83,01,01,01,01,01,23,18,18,18,18,18,18,18,18
00,00,00,00,00,00,00,87,57,57,57,57,57,57,01,40,83,83,83,83,83,83,83,83,83,83,01,49,01,01,01,26,18,18,18,18,18,18,18,18
00,00,00,00,00,00,00,87,57,28,32,28,28,57,01,40,83,83,83,83,83,83,83,83,83,83,01,01,01,01,22,18,18,18,18,18,18,18,18,18
00,00,00,00,00,00,00,87,57,45,55,28,28,40,40,40,83,83,83,83,83,57,57,57,57,57,01,01,01,01,22,18,18,18,18,18,18,18,18,18
00,00,00,00,00,00,00,87,57,28,32,28,28,57,01,40,83,83,83,83,83,57,40,40,40,57,01,01,01,01,26,18,18,18,18,18,18,18,18,18
00,00,00,00,00,00,00,87,57,28,32,28,28,57,01,40,83,83,83,83,83,57,40,103,40,57,01,01,01,22,18,18,18,18,18,18,18,18,18,18
00,00,00,00,00,00,00,87,57,57,57,57,57,57,03,40,40,40,40,40,40,40,40,40,40,57,01,01,01,22,18,18,18,18,18,18,18,18,18,18
00,00,00,00,00,00,00,87,01,01,01,84,01,01,01,01,83,83,83,83,83,57,40,40,40,57,01,01,01,22,18,18,18,18,18,18,18,18,18,18
00,00,00,00,00,00,00,87,01,01,85,01,01,01,01,01,83,83,83,83,83,57,57,57,57,57,01,01,01,22,18,18,18,18,18,18,18,18,18,18
00,00,00,00,00,00,00,87,87,87,87,87,87,87,87,87,87,87,87,87,87,87,87,87,87,87,87,87,87,87,18,18,18,18,18,18,18,18,18,18
00,00,00,00,00,00,00,00,00,00,00,00,00,00,00,00,00,00,00,00,00,00,00,00,00,00,00,00,00,00,18,18,18,18,18,18,18,18,18,18
00,00,00,00,00,00,00,00,00,00,00,00,00,00,00,00,00,00,00,00,00,00,00,00,00,00,00,00,00,00,18,18,18,18,18,18,18,18,18,18
00,00,00,00,00,00,00,00,00,00,00,00,00,00,00,00,00,00,00,00,00,00,00,00,00,00,00,00,00,00,18,18,18,18,18,18,18,18,18,18
00,00,00,00,00,00,00,00,00,00,00,00,00,00,00,00,00,00,00,00,00,00,00,00,00,00,00,00,00,00,18,18,18,18,18,18,18,18,18,18