34,28
02,02,02,02,02,02,02,02,02,02,02,02,02,02,02,02,02,02,02,02,02,02,02,02,02,02,02,02,02,02,02,02,02,02
02,02,02,02,02,02,02,02,02,02,02,02,02,02,02,02,02,02,02,02,02,02,02,02,02,02,02,02,02,02,02,02,02,02
02,02,02,02,02,02,02,02,02,02,02,02,02,02,02,02,02,02,02,02,02,02,02,02,02,02,02,02,02,02,02,02,02,02
02,02,02,02,02,02,02,02,02,02,02,02,02,02,02,02,02,02,02,02,02,02,02,02,02,02,02,02,02,02,02,02,02,02
02,02,02,02,02,02,02,02,02,02,02,02,02,02,02,02,02,02,02,02,02,02,02,02,02,02,02,02,02,02,02,02,02,02
02,02,02,02,02,02,02,02,59,02,40,40,40,40,40,40,44,40,40,40,40,44,40,40,40,40,02,02,02,02,02,02,02,02
02,02,02,02,02,02,02,02,40,40,40,44,40,43,40,40,44,02,02,40,40,40,44,40,44,40,02,02,02,02,02,02,02,02
02,02,02,02,02,02,02,02,40,02,02,40,40,40,40,44,40,02,02,40,40,02,02,40,40,40,02,02,02,02,02,02,02,02
02,02,02,02,02,02,02,02,40,02,02,40,40,02,02,40,40,40,40,40,40,02,02,40,44,40,02,02,02,02,02,02,02,02
02,02,02,02,02,02,02,02,40,40,40,40,40,02,02,40,40,02,02,40,40,40,40,40,40,44,02,02,02,02,02,02,02,02
02,02,02,02,02,02,02,02,40,02,02,40,40,40,40,40,44,02,02,43,40,02,02,44,44,40,02,02,02,02,02,02,02,02
02,02,02,02,02,02,02,02,40,02,02,44,40,02,02,44,43,40,40,44,40,02,02,40,40,40,02,02,02,02,02,02,02,02
02,02,02,02,02,02,02,02,40,40,40,40,40,02,02,40,40,02,02,40,40,40,40,40,44,40,02,02,02,02,02,02,02,02
02,02,02,02,02,02,02,02,40,02,02,40,40,43,40,40,40,02,02,44,40,02,02,40,43,40,02,02,02,02,02,02,02,02
02,02,02,02,02,02,02,02,43,02,02,40,40,02,02,40,40,40,40,40,44,02,02,44,40,40,02,02,02,02,02,02,02,02
02,02,02,02,02,02,02,02,40,40,40,40,40,02,02,40,40,02,02,40,40,40,43,40,44,40,02,02,02,02,02,02,02,02
02,02,02,02,02,02,02,02,40,02,02,40,40,40,44,40,40,02,02,44,40,02,02,44,40,40,02,02,02,02,02,02,02,02
02,02,02,02,02,02,02,02,40,02,02,40,40,02,02,40,40,40,40,43,44,02,02,40,40,40,02,02,02,02,02,02,02,02
02,02,02,02,02,02,02,02,40,40,40,40,40,02,02,40,40,02,02,40,40,40,40,44,40,43,02,02,02,02,02,02,02,02
02,02,02,02,02,02,02,02,44,02,02,40,40,40,40,40,40,02,02,40,40,02,02,40,40,40,02,02,02,02,02,02,02,02
02,02,02,02,02,02,02,02,40,02,02,40,44,02,02,40,44,40,40,43,40,02,02,40,40,40,02,02,02,02,02,02,02,02
02,02,02,02,02,02,02,02,40,40,40,40,40,02,02,44,40,40,40,40,40,40,44,40,02,02,02,02,02,02,02,02,02,02
02,02,02,02,02,02,02,02,44,40,40,43,40,40,40,44,40,40,40,40,40,44,40,40,43,61,02,02,02,02,02,02,02,02
02,02,02,02,02,02,02,02,02,02,02,02,02,02,02,02,02,02,02,02,02,02,02,02,02,02,02,02,02,02,02,02,02,02
02,02,02,02,02,02,02,02,02,02,02,02,02,02,02,02,02,02,02,02,02,02,02,02,02,02,02,02,02,02,02,02,02,02
02,02,02,02,02,02,02,02,02,02,02,02,02,02,02,02,02,02,02,02,02,02,02,02,02,02,02,02,02,02,02,02,02,02
02,02,02,02,02,02,02,02,02,02,02,02,02,02,02,02,02,02,02,02,02,02,02,02,02,02,02,02,02,02,02,02,02,02
02,02,02,02,02,02,02,02,02,02,02,02,02,02,02,02,02,02,02,02,02,02,02,02,02,02,02,02,02,02,02,02,02,02