34,28
02,02,02,02,02,02,02,02,02,02,02,02,02,02,02,02,02,02,02,02,02,02,02,02,02,02,02,02,02,02,02,02,02,02
02,02,02,02,02,02,02,02,02,02,02,02,02,02,02,02,02,02,02,02,02,02,02,02,02,02,02,02,02,02,02,02,02,02
02,02,02,02,02,02,02,02,02,02,02,02,02,02,02,02,02,02,02,02,02,02,02,02,02,02,02,02,02,02,02,02,02,02
02,02,02,02,02,02,02,02,02,02,02,02,02,02,02,02,02,02,02,02,02,02,02,02,02,02,02,02,02,02,02,02,02,02
02,02,02,02,02,02,02,02,02,02,02,02,02,02,02,02,02,02,02,02,02,02,02,02,02,02,02,02,02,02,02,02,02,02
02,02,02,02,02,02,02,02,61,40,40,02,02,02,02,02,02,02,02,40,40,40,40,40,40,40,02,02,02,02,02,02,02,02
02,02,02,02,02,02,02,02,02,02,40,40,40,40,40,40,02,02,02,40,02,02,02,02,02,40,02,02,02,02,02,02,02,02
02,02,02,02,02,02,02,02,02,02,02,02,02,02,02,40,40,40,40,40,02,02,02,02,02,40,02,02,02,02,02,02,02,02
02,02,02,02,02,02,02,02,02,40,40,40,40,40,02,02,02,02,02,02,02,02,02,02,02,40,02,02,02,02,02,02,02,02
02,02,02,02,02,02,02,02,02,02,02,02,02,40,02,40,40,40,40,40,02,02,40,40,40,40,02,02,02,02,02,02,02,02
02,02,02,02,02,02,02,02,40,02,02,02,02,40,02,02,02,02,02,40,02,02,40,02,02,02,02,02,02,02,02,02,02,02
02,02,02,02,02,02,02,02,40,40,40,40,40,40,40,40,40,40,02,40,40,40,40,02,02,02,02,02,02,02,02,02,02,02
02,02,02,02,02,02,02,02,02,40,02,02,02,02,02,02,02,40,02,02,02,02,40,02,02,02,02,02,02,02,02,02,02,02
02,02,02,02,02,02,02,02,02,40,02,40,40,40,40,40,02,40,40,40,40,02,40,02,02,02,02,02,02,02,02,02,02,02
02,02,02,02,02,02,02,02,02,40,02,40,02,02,02,40,02,40,02,02,40,02,40,40,40,02,02,02,02,02,02,02,02,02
02,02,02,02,02,02,02,02,02,40,02,40,02,02,02,40,40,40,02,02,40,02,02,02,40,02,02,02,02,02,02,02,02,02
02,02,02,02,02,02,02,02,02,02,02,02,02,02,02,02,02,02,02,02,40,40,40,02,40,02,02,02,02,02,02,02,02,02
02,02,02,02,02,02,02,02,02,02,40,40,40,40,02,02,02,02,02,02,02,02,40,02,40,02,02,02,02,02,02,02,02,02
02,02,02,02,02,02,02,02,02,02,40,02,02,40,40,40,40,40,40,40,40,02,40,02,40,02,02,02,02,02,02,02,02,02
02,02,02,02,02,02,02,02,40,40,40,02,02,02,02,02,40,02,02,02,40,02,40,02,40,02,02,02,02,02,02,02,02,02
02,02,02,02,02,02,02,02,40,02,02,02,02,02,02,02,40,02,02,02,40,02,40,02,40,02,02,02,02,02,02,02,02,02
02,02,02,02,02,02,02,02,40,02,40,40,40,40,40,40,40,02,02,02,40,02,40,02,40,02,02,02,02,02,02,02,02,02
02,02,02,02,02,02,02,02,40,02,02,02,02,02,02,02,02,02,02,02,40,40,40,40,40,59,02,02,02,02,02,02,02,02
02,02,02,02,02,02,02,02,02,02,02,02,02,02,02,02,02,02,02,02,02,02,02,02,02,02,02,02,02,02,02,02,02,02
02,02,02,02,02,02,02,02,02,02,02,02,02,02,02,02,02,02,02,02,02,02,02,02,02,02,02,02,02,02,02,02,02,02
02,02,02,02,02,02,02,02,02,02,02,02,02,02,02,02,02,02,02,02,02,02,02,02,02,02,02,02,02,02,02,02,02,02
02,02,02,02,02,02,02,02,02,02,02,02,02,02,02,02,02,02,02,02,02,02,02,02,02,02,02,02,02,02,02,02,02,02
02,02,02,02,02,02,02,02,02,02,02,02,02,02,02,02,02,02,02,02,02,02,02,02,02,02,02,02,02,02,02,02,02,02