24,18
00,00,00,00,00,00,00,00,00,00,00,00,00,00,00,00,00,00,00,00,00,00,00,00
00,00,00,00,00,00,00,00,00,00,00,00,00,00,00,00,00,00,00,00,00,00,00,00
00,00,00,00,00,00,00,00,00,00,00,00,00,00,00,00,00,00,00,00,00,00,00,00
00,00,00,00,00,00,00,00,00,00,00,00,00,00,00,00,00,00,00,00,00,00,00,00
00,00,00,00,00,00,00,02,02,02,02,02,02,02,02,02,02,00,00,00,00,00,00,00
00,00,00,00,00,00,00,02,02,02,02,02,02,02,02,02,02,00,00,00,00,00,00,00
00,00,00,00,00,00,00,02,02,02,02,02,02,02,02,02,02,00,00,00,00,00,00,00
00,00,00,00,00,00,00,02,02,40,40,40,02,02,02,02,02,00,00,00,00,00,00,00
00,00,00,00,00,00,00,02,02,126,40,40,02,02,02,02,02,00,00,00,00,00,00,00
00,00,00,00,00,00,00,02,02,124,40,40,40,40,40,59,02,00,00,00,00,00,00,00
00,00,00,00,00,00,00,02,02,126,40,40,02,02,02,02,02,00,00,00,00,00,00,00
00,00,00,00,00,00,00,02,02,40,40,40,02,02,02,02,02,00,00,00,00,00,00,00
00,00,00,00,00,00,00,02,02,02,02,02,02,02,02,02,02,00,00,00,00,00,00,00
00,00,00,00,00,00,00,02,02,02,02,02,02,02,02,02,02,00,00,00,00,00,00,00
00,00,00,00,00,00,00,00,00,00,00,00,00,00,00,00,00,00,00,00,00,00,00,00
00,00,00,00,00,00,00,00,00,00,00,00,00,00,00,00,00,00,00,00,00,00,00,00
00,00,00,00,00,00,00,00,00,00,00,00,00,00,00,00,00,00,00,00,00,00,00,00
00,00,00,00,00,00,00,00,00,00,00,00,00,00,00,00,00,00,00,00,00,00,00,00