44,30
00,00,00,00,00,00,00,00,00,00,00,00,00,00,00,00,00,00,00,00,00,00,00,00,00,00,00,00,00,00,00,00,00,00,00,00,00,00,00,00,00,00,00,00
00,00,00,00,00,00,00,00,00,00,00,00,00,00,00,00,00,00,00,00,00,00,00,00,00,00,00,00,00,00,00,00,00,00,00,00,00,00,00,00,00,00,00,00
00,00,00,00,00,00,00,00,00,00,00,00,00,00,00,00,00,00,00,00,00,00,00,00,00,00,00,00,00,00,00,00,00,00,00,00,00,00,00,00,00,00,00,00
00,00,00,00,00,00,00,00,00,00,00,00,00,00,00,00,00,00,00,00,00,00,00,00,00,00,00,00,00,00,00,00,00,00,00,00,00,00,00,00,00,00,00,00
00,00,00,00,00,00,00,29,29,29,29,29,29,29,29,29,29,29,29,29,29,29,29,29,29,29,29,29,29,29,29,29,29,29,29,29,29,00,00,00,00,00,00,00
00,00,00,00,00,00,00,29,01,03,01,01,01,01,01,01,01,01,01,05,05,05,05,05,05,05,05,01,01,01,01,01,01,01,03,03,29,00,00,00,00,00,00,00
00,00,00,00,00,00,00,29,01,01,01,01,01,01,01,01,01,01,01,05,28,32,28,28,28,28,05,01,01,01,01,01,01,01,01,03,29,00,00,00,00,00,00,00
00,00,00,00,00,00,00,29,01,01,01,01,01,01,01,01,01,01,01,05,45,54,28,28,28,28,05,01,01,01,01,01,01,01,01,01,29,00,00,00,00,00,00,00
00,00,00,00,00,00,00,29,01,05,05,05,05,05,05,05,05,01,01,05,28,32,28,28,28,28,05,01,01,03,01,01,01,01,01,01,29,00,00,00,00,00,00,00
00,00,00,00,00,00,00,29,01,05,28,32,28,28,28,28,05,01,01,05,05,05,05,28,28,05,05,01,01,01,49,01,01,01,01,01,29,00,00,00,00,00,00,00
00,00,00,00,00,00,00,29,01,05,45,55,28,28,28,28,05,01,01,01,01,01,01,27,27,01,01,01,01,01,01,01,03,01,01,01,29,00,00,00,00,00,00,00
00,00,00,00,00,00,00,29,01,05,28,32,28,28,28,28,05,01,01,01,01,01,01,27,27,01,01,01,01,01,01,01,01,01,01,01,29,00,00,00,00,00,00,00
00,00,00,00,00,00,00,29,01,05,28,32,28,28,28,28,05,01,01,01,01,01,01,27,27,01,04,04,04,04,04,04,04,04,04,01,29,00,00,00,00,00,00,00
00,00,00,00,00,00,00,29,01,05,05,05,05,05,28,28,05,01,01,01,01,01,01,27,27,01,04,28,47,45,47,28,28,28,04,01,29,00,00,00,00,00,00,00
00,00,00,00,00,00,00,29,01,01,01,01,01,01,27,27,01,01,01,01,01,01,48,27,27,01,04,28,34,46,35,28,28,28,04,01,29,00,00,00,00,00,00,00
00,00,00,00,00,00,00,29,01,01,01,01,27,27,27,27,27,27,27,27,27,27,27,27,27,01,04,28,28,28,28,28,28,28,04,01,29,00,00,00,00,00,00,00
00,00,00,00,00,00,00,29,01,01,01,01,27,27,27,27,27,27,27,27,27,27,27,27,27,01,04,28,28,28,28,36,37,51,04,01,29,00,00,00,00,00,00,00
00,00,00,00,00,00,00,29,01,01,01,01,27,27,01,01,01,01,01,01,01,01,01,27,27,01,04,28,28,28,28,28,28,28,04,01,29,00,00,00,00,00,00,00
00,00,00,00,00,00,00,29,01,03,01,50,27,27,01,05,05,05,05,05,05,05,01,27,27,01,04,28,28,28,28,28,28,28,04,01,29,00,00,00,00,00,00,00
00,00,00,00,00,00,00,29,01,01,01,01,27,27,01,05,28,28,28,32,28,05,01,27,27,27,28,28,28,28,28,38,52,28,04,01,29,00,00,00,00,00,00,00
00,00,00,00,00,00,00,29,01,01,01,01,27,27,01,05,28,28,28,53,45,05,01,27,27,27,28,28,28,28,28,39,28,28,04,01,29,00,00,00,00,00,00,00
00,00,00,00,00,00,00,29,01,01,01,01,27,27,27,28,28,28,28,32,28,05,01,27,27,01,04,28,28,28,28,28,28,28,04,01,29,00,00,00,00,00,00,00
00,00,00,00,00,00,00,29,01,01,01,01,27,27,27,28,28,28,28,32,28,05,01,27,27,01,04,04,04,04,04,04,04,04,04,01,29,00,00,00,00,00,00,00
00,00,00,00,00,00,00,29,03,01,01,01,01,01,01,05,05,05,05,05,05,05,01,27,27,01,01,01,01,01,01,01,01,01,01,01,29,00,00,00,00,00,00,00
00,00,00,00,00,00,00,29,29,29,29,29,29,29,29,29,29,29,29,29,29,29,29,27,27,29,29,29,29,29,29,29,29,29,29,29,29,00,00,00,00,00,00,00
00,00,00,00,00,00,00,00,00,00,00,00,00,00,00,00,00,00,00,00,00,00,00,87,87,00,00,00,00,00,00,00,00,00,00,00,00,00,00,00,00,00,00,00
00,00,00,00,00,00,00,00,00,00,00,00,00,00,00,00,00,00,00,00,00,00,00,00,00,00,00,00,00,00,00,00,00,00,00,00,00,00,00,00,00,00,00,00
00,00,00,00,00,00,00,00,00,00,00,00,00,00,00,00,00,00,00,00,00,00,00,00,00,00,00,00,00,00,00,00,00,00,00,00,00,00,00,00,00,00,00,00
00,00,00,00,00,00,00,00,00,00,00,00,00,00,00,00,00,00,00,00,00,00,00,00,00,00,00,00,00,00,00,00,00,00,00,00,00,00,00,00,00,00,00,00
00,00,00,00,00,00,00,00,00,00,00,00,00,00,00,00,00,00,00,00,00,00,00,00,00,00,00,00,00,00,00,00,00,00,00,00,00,00,00,00,00,00,00,00
