28,18
00,00,00,00,00,00,00,00,00,00,00,00,00,00,00,00,00,00,00,00,00,00,00,00,00,00,00,00
00,00,00,00,00,00,00,00,00,00,00,00,00,00,00,00,00,00,00,00,00,00,00,00,00,00,00,00
00,00,00,00,00,00,00,00,00,00,00,00,00,00,00,00,00,00,00,00,00,00,00,00,00,00,00,00
00,00,00,00,00,00,00,00,00,00,00,00,00,00,00,00,00,00,00,00,00,00,00,00,00,00,00,00
01,01,01,01,01,01,01,01,01,01,01,01,01,11,09,09,09,09,09,09,09,09,09,09,09,09,09,09
01,01,01,01,01,01,01,01,01,01,01,01,01,01,11,09,09,09,09,09,09,09,09,09,09,09,09,09
01,01,01,01,01,01,01,01,01,01,01,01,01,17,13,13,15,11,09,09,09,09,09,09,09,09,09,09
01,01,01,01,01,01,01,01,01,01,01,01,01,17,13,13,13,15,11,09,09,09,09,09,09,09,09,09
01,01,01,01,01,01,01,01,01,01,01,01,17,13,13,13,93,13,15,11,09,09,09,09,09,09,09,09
01,01,01,01,01,01,01,01,01,01,01,01,17,13,13,13,13,15,11,09,09,09,09,09,09,09,09,09
01,01,01,01,01,01,01,01,01,01,01,01,01,17,13,13,15,11,09,09,09,09,09,09,09,09,09,09
01,01,01,01,01,01,01,01,01,01,01,01,01,16,12,14,11,09,09,09,09,09,09,09,09,09,09,09
01,01,01,01,01,01,01,01,01,01,01,01,01,01,11,09,09,09,09,09,09,09,09,09,09,09,09,09
01,01,01,01,01,01,01,01,01,01,01,01,01,11,09,09,09,09,09,09,09,09,09,09,09,09,09,09
00,00,00,00,00,00,00,00,00,00,00,00,00,00,00,00,00,00,00,00,00,00,00,00,00,00,00,00
00,00,00,00,00,00,00,00,00,00,00,00,00,00,00,00,00,00,00,00,00,00,00,00,00,00,00,00
00,00,00,00,00,00,00,00,00,00,00,00,00,00,00,00,00,00,00,00,00,00,00,00,00,00,00,00
00,00,00,00,00,00,00,00,00,00,00,00,00,00,00,00,00,00,00,00,00,00,00,00,00,00,00,00