40,32
00,00,00,00,00,00,00,00,00,00,00,00,00,00,00,00,00,00,00,00,00,00,00,00,00,00,00,00,00,00,00,00,00,00,00,00,00,00,00,00
00,00,00,00,00,00,00,00,00,00,00,00,00,00,00,00,00,00,00,00,00,00,00,00,00,00,00,00,00,00,00,00,00,00,00,00,00,00,00,00
00,00,00,00,00,00,00,00,00,00,00,00,00,00,00,00,00,00,00,00,00,00,00,00,00,00,00,00,00,00,00,00,00,00,00,00,00,00,00,00
00,00,00,00,00,00,00,00,00,00,00,00,00,00,00,00,00,00,00,00,00,00,00,00,00,00,00,00,00,00,00,00,00,00,00,00,00,00,00,00
00,00,00,00,00,00,00,00,29,29,29,29,29,29,29,29,29,29,29,29,29,29,29,29,29,29,29,29,29,29,29,29,29,00,00,00,00,00,00,00
00,00,00,00,00,00,00,00,29,28,28,28,28,28,28,28,28,28,28,28,28,28,28,28,28,28,28,28,28,28,28,67,29,00,00,00,00,00,00,00
00,00,00,00,00,00,00,00,29,28,29,29,40,29,29,29,29,29,29,29,29,29,29,29,29,29,29,29,29,29,29,28,29,00,00,00,00,00,00,00
00,00,00,00,00,00,00,00,29,28,29,40,40,40,40,40,40,40,40,40,40,40,40,40,40,40,40,40,40,40,29,28,29,00,00,00,00,00,00,00
00,00,00,00,00,00,00,00,29,28,29,40,40,40,40,40,40,05,05,05,05,05,40,40,40,40,40,72,40,40,29,28,29,00,00,00,00,00,00,00
00,00,00,00,00,00,00,00,29,28,29,40,40,40,40,40,40,05,28,45,28,05,40,40,40,40,40,40,40,40,29,28,29,00,00,00,00,00,00,00
00,00,00,00,00,00,00,00,29,28,29,40,40,73,40,40,40,05,33,66,33,05,40,40,05,05,05,05,05,05,29,28,29,00,00,00,00,00,00,00
00,00,00,00,00,00,00,00,29,28,29,40,40,40,40,40,40,05,28,28,28,05,40,40,05,28,28,28,28,28,29,28,29,00,00,00,00,00,00,00
00,00,00,00,00,00,00,00,29,28,29,40,40,40,40,40,40,05,05,27,05,05,40,40,05,28,28,28,28,64,29,28,29,00,00,00,00,00,00,00
00,00,00,00,00,00,00,00,29,67,29,40,40,40,40,40,40,40,40,27,40,40,40,40,05,28,28,28,28,28,29,28,29,00,00,00,00,00,00,00
00,00,00,00,00,00,00,00,29,29,29,40,40,40,40,40,40,40,40,27,40,40,40,40,05,28,28,05,05,05,29,28,29,00,00,00,00,00,00,00
00,00,00,00,00,00,00,87,27,27,27,27,27,27,27,27,27,27,27,27,27,27,27,27,05,28,28,28,28,28,29,28,29,00,00,00,00,00,00,00
00,00,00,00,00,00,00,87,27,27,27,27,27,27,27,27,27,27,27,27,27,27,27,27,05,28,28,28,28,28,29,28,29,00,00,00,00,00,00,00
00,00,00,00,00,00,00,00,29,29,29,40,40,40,40,40,40,40,40,40,40,104,27,27,05,28,28,28,28,28,29,28,29,00,00,00,00,00,00,00
00,00,00,00,00,00,00,00,29,67,29,40,40,40,40,40,40,40,40,40,40,40,27,27,05,28,28,05,05,05,29,28,29,00,00,00,00,00,00,00
00,00,00,00,00,00,00,00,29,28,29,40,40,40,40,40,40,40,40,40,40,40,27,27,05,28,28,28,28,28,29,28,29,00,00,00,00,00,00,00
00,00,00,00,00,00,00,00,29,28,29,40,40,40,05,05,05,05,05,05,40,40,27,27,05,28,28,28,28,28,29,28,29,00,00,00,00,00,00,00
00,00,00,00,00,00,00,00,29,28,29,40,40,40,05,45,53,28,28,05,40,40,27,27,05,28,28,28,28,28,29,28,29,00,00,00,00,00,00,00
00,00,00,00,00,00,00,00,29,28,29,40,40,40,05,69,35,28,28,05,40,40,27,27,05,05,05,27,05,05,29,28,29,00,00,00,00,00,00,00
00,00,00,00,00,00,00,00,29,28,29,40,78,40,05,28,28,28,28,27,27,27,27,27,27,27,27,27,27,27,29,28,29,00,00,00,00,00,00,00
00,00,00,00,00,00,00,00,29,28,29,40,40,40,05,28,28,28,28,27,27,27,27,27,27,27,27,27,27,27,29,28,29,00,00,00,00,00,00,00
00,00,00,00,00,00,00,00,29,28,29,29,29,29,29,29,29,29,29,29,29,29,29,29,29,29,29,29,29,29,29,28,29,00,00,00,00,00,00,00
00,00,00,00,00,00,00,00,29,67,28,28,28,28,28,28,28,28,28,28,28,28,28,28,28,28,28,28,28,28,28,67,29,00,00,00,00,00,00,00
00,00,00,00,00,00,00,00,29,29,29,29,29,29,29,29,29,29,29,29,29,29,29,29,29,29,29,29,29,29,29,29,29,00,00,00,00,00,00,00
00,00,00,00,00,00,00,00,00,00,00,00,00,00,00,00,00,00,00,00,00,00,00,00,00,00,00,00,00,00,00,00,00,00,00,00,00,00,00,00
00,00,00,00,00,00,00,00,00,00,00,00,00,00,00,00,00,00,00,00,00,00,00,00,00,00,00,00,00,00,00,00,00,00,00,00,00,00,00,00
00,00,00,00,00,00,00,00,00,00,00,00,00,00,00,00,00,00,00,00,00,00,00,00,00,00,00,00,00,00,00,00,00,00,00,00,00,00,00,00
00,00,00,00,00,00,00,00,00,00,00,00,00,00,00,00,00,00,00,00,00,00,00,00,00,00,00,00,00,00,00,00,00,00,00,00,00,00,00,00