32,29
00,00,00,00,00,00,00,00,00,00,00,00,00,00,00,00,00,00,00,00,00,00,00,00,00,00,00,00,00,00,00,00
00,00,00,00,00,00,00,00,00,00,00,00,00,00,00,00,00,00,00,00,00,00,00,00,00,00,00,00,00,00,00,00
00,00,00,00,00,00,00,00,00,00,00,00,00,00,00,00,00,00,00,00,00,00,00,00,00,00,00,00,00,00,00,00
00,00,00,00,00,00,00,00,00,00,00,00,00,00,00,00,00,00,00,00,00,00,00,00,00,00,00,00,00,00,00,00
00,00,00,00,00,00,00,29,29,29,29,29,29,29,29,29,29,29,29,29,29,29,29,29,29,00,00,00,00,00,00,00
00,00,00,00,00,00,00,29,28,28,45,28,28,28,57,27,61,57,28,28,28,45,28,28,29,00,00,00,00,00,00,00
00,00,00,00,00,00,00,29,33,33,68,33,33,33,57,27,27,57,33,33,33,66,33,33,29,00,00,00,00,00,00,00
00,00,00,00,00,00,00,29,28,28,28,28,28,28,57,27,27,57,28,28,28,28,28,28,29,00,00,00,00,00,00,00
00,00,00,00,00,00,00,29,28,28,28,28,28,28,57,27,27,57,28,28,28,28,67,28,29,00,00,00,00,00,00,00
00,00,00,00,00,00,00,29,57,57,28,57,57,57,57,27,27,57,57,57,57,28,57,57,29,00,00,00,00,00,00,00
00,00,00,00,00,00,00,29,28,28,28,28,28,28,28,27,27,28,28,28,28,28,28,28,29,00,00,00,00,00,00,00
00,00,00,00,00,00,00,29,28,28,28,28,28,28,28,27,27,28,28,28,28,28,28,28,29,00,00,00,00,00,00,00
00,00,00,00,00,00,00,29,28,28,28,28,28,28,28,27,27,28,28,28,28,28,28,28,29,00,00,00,00,00,00,00
00,00,00,00,00,00,00,29,28,28,28,28,28,28,28,27,27,28,28,28,28,28,28,28,29,00,00,00,00,00,00,00
00,00,00,00,00,00,00,29,28,28,74,28,28,28,28,27,27,28,28,28,28,28,28,28,29,00,00,00,00,00,00,00
00,00,00,00,00,00,00,29,28,28,28,28,28,28,28,27,27,28,28,28,28,28,28,28,29,00,00,00,00,00,00,00
00,00,00,00,00,00,00,29,29,29,29,29,29,29,29,27,27,29,29,29,29,29,29,29,29,00,00,00,00,00,00,00
00,00,00,00,00,00,00,29,28,28,28,28,28,28,28,28,28,28,28,28,28,28,28,28,29,00,00,00,00,00,00,00
00,00,00,00,00,00,00,29,28,28,28,28,28,64,28,28,28,28,28,28,28,28,28,28,29,00,00,00,00,00,00,00
00,00,00,00,00,00,00,29,28,28,28,28,28,28,28,28,28,28,28,28,28,28,28,28,29,00,00,00,00,00,00,00
00,00,00,00,00,00,00,29,62,65,65,65,65,65,65,65,28,28,28,28,28,28,28,28,29,00,00,00,00,00,00,00
00,00,00,00,00,00,00,29,28,28,28,28,28,28,28,28,28,28,28,28,28,28,28,28,29,00,00,00,00,00,00,00
00,00,00,00,00,00,00,29,28,63,28,28,28,28,28,28,28,28,28,28,28,28,28,28,29,00,00,00,00,00,00,00
00,00,00,00,00,00,00,29,29,29,29,29,29,29,29,29,29,29,29,29,29,29,29,29,29,00,00,00,00,00,00,00
00,00,00,00,00,00,00,00,00,00,00,00,00,00,00,00,00,00,00,00,00,00,00,00,00,00,00,00,00,00,00,00
00,00,00,00,00,00,00,00,00,00,00,00,00,00,00,00,00,00,00,00,00,00,00,00,00,00,00,00,00,00,00,00
00,00,00,00,00,00,00,00,00,00,00,00,00,00,00,00,00,00,00,00,00,00,00,00,00,00,00,00,00,00,00,00
00,00,00,00,00,00,00,00,00,00,00,00,00,00,00,00,00,00,00,00,00,00,00,00,00,00,00,00,00,00,00,00
00,00,00,00,00,00,00,00,00,00,00,00,00,00,00,00,00,00,00,00,00,00,00,00,00,00,00,00,00,00,00,00