32,29
00,00,00,00,00,00,00,00,00,00,00,00,00,00,00,00,00,00,00,00,00,00,00,00,00,00,00,00,00,00,00,00
00,00,00,00,00,00,00,00,00,00,00,00,00,00,00,00,00,00,00,00,00,00,00,00,00,00,00,00,00,00,00,00
00,00,00,00,00,00,00,00,00,00,00,00,00,00,00,00,00,00,00,00,00,00,00,00,00,00,00,00,00,00,00,00
00,00,00,00,00,00,00,00,00,00,00,00,00,00,00,00,00,00,00,00,00,00,00,00,00,00,00,00,00,00,00,00
00,00,00,00,00,00,00,29,29,29,29,29,29,29,29,29,29,29,29,29,29,29,29,29,29,00,00,00,00,00,00,00
00,00,00,00,00,00,00,29,28,28,45,28,28,28,57,27,59,57,28,28,45,28,28,28,29,00,00,00,00,00,00,00
00,00,00,00,00,00,00,29,33,33,69,33,33,33,57,27,27,57,33,33,70,33,33,33,29,00,00,00,00,00,00,00
00,00,00,00,00,00,00,29,28,28,28,28,28,28,57,27,27,57,28,28,28,28,28,28,29,00,00,00,00,00,00,00
00,00,00,00,00,00,00,29,28,28,28,28,28,28,57,27,27,57,28,28,28,28,28,28,29,00,00,00,00,00,00,00
00,00,00,00,00,00,00,29,57,57,28,57,57,57,57,27,27,57,57,57,57,28,57,57,29,00,00,00,00,00,00,00
00,00,00,00,00,00,00,29,40,40,40,40,40,40,40,27,27,40,40,40,40,40,40,40,29,00,00,00,00,00,00,00
00,00,00,00,00,00,00,29,40,40,40,40,40,40,27,27,27,27,40,40,40,40,40,40,29,00,00,00,00,00,00,00
00,00,00,00,00,00,00,29,40,40,40,40,40,27,27,27,27,27,27,40,40,40,40,40,29,00,00,00,00,00,00,00
00,00,00,00,00,00,00,29,40,40,40,40,40,27,71,18,18,27,27,40,40,40,40,40,29,00,00,00,00,00,00,00
00,00,00,00,00,00,00,29,40,40,40,40,40,27,27,18,18,27,27,40,40,40,40,40,29,00,00,00,00,00,00,00
00,00,00,00,00,00,00,29,40,40,40,40,40,27,27,27,27,27,27,40,40,40,40,40,29,00,00,00,00,00,00,00
00,00,00,00,00,00,00,29,40,40,40,40,40,40,27,27,27,27,40,40,40,40,40,40,29,00,00,00,00,00,00,00
00,00,00,00,00,00,00,29,40,40,40,40,40,40,40,27,27,40,40,40,40,73,40,40,29,00,00,00,00,00,00,00
00,00,00,00,00,00,00,29,40,40,40,40,40,40,40,27,27,40,40,40,40,40,40,40,29,00,00,00,00,00,00,00
00,00,00,00,00,00,00,29,40,40,40,40,40,40,40,27,27,40,40,40,40,40,40,40,29,00,00,00,00,00,00,00
00,00,00,00,00,00,00,29,40,40,40,40,40,40,40,27,27,40,40,40,40,40,40,40,29,00,00,00,00,00,00,00
00,00,00,00,00,00,00,29,72,40,40,40,40,40,40,27,27,40,40,40,40,40,40,40,29,00,00,00,00,00,00,00
00,00,00,00,00,00,00,29,40,40,40,40,40,40,40,27,27,40,40,40,40,40,40,40,29,00,00,00,00,00,00,00
00,00,00,00,00,00,00,29,29,29,29,29,29,29,29,27,27,29,29,29,29,29,29,29,29,00,00,00,00,00,00,00
00,00,00,00,00,00,00,00,00,00,00,00,00,00,00,87,87,00,00,00,00,00,00,00,00,00,00,00,00,00,00,00
00,00,00,00,00,00,00,00,00,00,00,00,00,00,00,00,00,00,00,00,00,00,00,00,00,00,00,00,00,00,00,00
00,00,00,00,00,00,00,00,00,00,00,00,00,00,00,00,00,00,00,00,00,00,00,00,00,00,00,00,00,00,00,00
00,00,00,00,00,00,00,00,00,00,00,00,00,00,00,00,00,00,00,00,00,00,00,00,00,00,00,00,00,00,00,00
00,00,00,00,00,00,00,00,00,00,00,00,00,00,00,00,00,00,00,00,00,00,00,00,00,00,00,00,00,00,00,00