42,34
00,00,00,00,00,00,00,00,00,00,00,00,00,00,00,00,00,00,00,00,00,00,00,00,00,00,00,00,00,00,00,00,00,00,00,00,00,00,00,00,00,00
00,00,00,00,00,00,00,00,00,00,00,00,00,00,00,00,00,00,00,00,00,00,00,00,00,00,00,00,00,00,00,00,00,00,00,00,00,00,00,00,00,00
00,00,00,00,00,00,00,00,00,00,00,00,00,00,00,00,00,00,00,00,00,00,00,00,00,00,00,00,00,00,00,00,00,00,00,00,00,00,00,00,00,00
00,00,00,00,00,00,00,00,00,00,00,00,00,00,00,00,00,00,00,00,00,00,00,00,00,00,00,00,00,00,00,00,00,00,00,00,00,00,00,00,00,00
00,00,00,00,00,00,00,87,87,87,87,87,87,87,87,87,87,87,87,87,87,87,87,87,87,87,87,87,87,87,87,87,87,87,87,18,18,18,18,18,18,18
00,00,00,00,00,00,00,87,01,01,01,01,01,01,01,01,01,01,01,01,01,01,01,01,01,03,01,01,01,01,01,01,01,22,18,18,18,18,18,18,18,18
00,00,00,00,00,00,00,87,01,03,01,01,01,01,01,29,29,29,29,29,29,29,01,01,01,01,01,84,01,01,01,01,01,22,18,18,18,18,18,18,18,18
00,00,00,00,00,00,00,87,01,01,01,01,01,01,84,29,28,28,45,28,28,29,01,01,01,01,01,01,01,01,01,01,01,22,18,18,18,18,18,18,18,18
00,00,00,00,00,00,00,87,01,01,01,01,01,01,01,29,33,33,70,33,33,29,01,01,01,01,01,01,03,01,01,01,01,26,18,18,18,18,18,18,18,18
00,00,00,00,00,00,00,87,01,01,01,01,01,01,01,29,28,28,28,28,28,29,01,01,01,29,29,29,29,29,29,03,22,18,18,18,18,18,18,18,18,18
00,00,00,00,00,00,00,87,01,01,01,01,01,01,01,29,28,28,28,28,28,29,01,01,01,29,28,28,28,28,29,01,22,18,18,18,18,18,18,18,18,18
00,00,00,00,00,00,00,87,01,01,01,01,01,01,01,29,29,29,28,29,29,29,01,01,01,29,28,28,28,38,29,01,22,18,18,18,18,18,18,18,18,18
00,00,00,00,00,00,00,87,01,01,01,84,01,01,01,01,01,03,27,03,01,01,84,01,01,29,28,28,28,39,29,01,22,18,18,18,18,18,18,18,18,18
00,00,00,00,00,00,00,87,01,01,01,01,01,01,01,01,01,01,27,01,01,01,01,01,01,29,28,28,28,28,29,01,01,23,18,18,18,18,18,18,18,18
00,00,00,00,00,00,00,87,01,01,05,05,05,05,05,05,01,01,27,01,01,01,01,01,01,29,29,28,29,29,29,01,01,22,18,18,18,18,18,18,18,18
00,00,00,00,00,00,00,87,01,01,05,45,53,28,28,05,01,01,27,03,01,01,01,01,01,01,01,27,01,01,01,01,01,26,18,18,18,18,18,18,18,18
00,00,00,00,00,00,00,87,01,01,05,28,32,28,28,05,01,01,27,01,01,01,01,85,01,01,01,27,01,01,01,03,22,18,18,18,18,18,18,18,18,18
00,00,00,00,00,00,00,87,01,01,05,33,35,28,28,28,27,27,27,27,27,27,27,27,27,27,27,27,27,27,27,27,88,88,88,18,18,18,18,18,18,18
00,00,00,00,00,00,00,87,01,03,05,28,28,28,28,28,27,27,27,27,27,27,27,27,27,27,27,27,27,27,27,27,88,88,98,18,18,18,18,18,18,18
00,00,00,00,00,00,00,87,01,01,05,28,05,05,05,05,03,01,01,01,27,27,01,01,01,01,01,27,01,01,84,01,22,18,18,18,18,18,18,18,18,18
00,00,00,00,00,00,00,87,01,01,05,28,05,36,37,05,01,01,01,01,27,27,01,03,01,01,01,27,01,01,01,01,22,18,18,18,18,18,18,18,18,18
00,00,00,00,00,00,00,87,01,01,05,28,28,28,28,05,01,01,01,01,27,27,01,01,29,29,29,28,29,29,29,01,01,23,18,18,18,18,18,18,18,18
00,00,00,00,00,00,00,87,01,01,05,28,05,28,28,05,01,01,84,01,27,27,01,01,29,28,28,28,28,28,29,01,01,22,18,18,18,18,18,18,18,18
00,00,00,00,00,00,00,87,01,01,05,28,05,28,28,05,01,01,01,01,27,27,27,27,28,28,28,28,28,28,29,01,01,22,18,18,18,18,18,18,18,18
00,00,00,00,00,00,00,87,01,01,05,05,05,05,05,05,01,01,01,01,27,27,01,01,29,28,28,28,28,28,29,01,03,22,18,18,18,18,18,18,18,18
00,00,00,00,00,00,00,87,84,01,01,01,01,01,01,85,01,03,01,01,27,27,01,01,29,33,33,66,33,33,29,84,85,01,23,18,18,18,18,18,18,18
00,00,00,00,00,00,00,87,01,01,01,01,03,01,01,01,01,03,01,01,27,27,01,01,29,28,28,45,28,28,29,01,01,01,22,18,18,18,18,18,18,18
00,00,00,00,00,00,00,87,01,01,01,01,01,01,01,01,01,01,01,01,27,27,01,01,29,29,29,29,29,29,29,01,01,01,26,18,18,18,18,18,18,18
00,00,00,00,00,00,00,87,01,01,01,01,01,84,01,01,01,01,01,84,27,27,01,01,01,01,01,03,03,01,01,01,01,22,18,18,18,18,18,18,18,18
00,00,00,00,00,00,00,87,87,87,87,87,87,87,87,87,87,87,87,87,87,87,87,87,87,87,87,87,87,87,87,87,87,87,18,18,18,18,18,18,18,18
00,00,00,00,00,00,00,00,00,00,00,00,00,00,00,00,00,00,00,00,00,00,00,00,00,00,00,00,00,00,00,00,00,00,00,00,00,00,00,00,00,00
00,00,00,00,00,00,00,00,00,00,00,00,00,00,00,00,00,00,00,00,00,00,00,00,00,00,00,00,00,00,00,00,00,00,00,00,00,00,00,00,00,00
00,00,00,00,00,00,00,00,00,00,00,00,00,00,00,00,00,00,00,00,00,00,00,00,00,00,00,00,00,00,00,00,00,00,00,00,00,00,00,00,00,00
00,00,00,00,00,00,00,00,00,00,00,00,00,00,00,00,00,00,00,00,00,00,00,00,00,00,00,00,00,00,00,00,00,00,00,00,00,00,00,00,00,00