28,21
01,01,01,01,01,01,01,01,01,01,01,01,01,01,01,01,01,01,01,01,01,01,01,01,01,01,01,01
01,01,01,01,01,01,01,01,01,01,01,01,01,01,01,01,01,01,01,01,01,01,01,01,01,01,01,01
01,01,01,01,01,84,84,84,01,01,01,01,01,01,01,01,01,01,01,01,01,01,01,01,01,01,01,01
01,01,01,01,01,01,01,01,01,01,01,01,01,01,01,01,03,01,01,01,01,01,01,01,01,01,01,01
01,01,01,01,01,01,01,90,90,90,90,90,90,90,90,90,90,90,90,90,90,01,01,01,01,01,01,01
01,01,01,01,01,01,01,90,28,28,100,90,28,60,28,28,90,36,37,28,90,01,01,01,01,01,01,01
01,01,03,01,01,01,01,90,28,28,99,90,28,28,28,28,90,28,28,28,90,01,01,01,01,01,01,01
01,01,01,01,01,01,01,90,28,90,90,90,28,28,28,28,90,28,28,28,90,01,01,01,01,01,01,01
01,01,01,01,01,01,01,90,28,28,28,90,90,01,01,90,90,28,36,37,90,01,01,03,01,01,01,01
01,01,01,01,01,01,01,90,28,28,28,90,03,01,01,03,90,28,28,28,90,01,01,01,01,01,01,01
01,01,01,01,01,01,01,90,28,28,28,90,83,01,01,83,90,28,74,28,90,01,01,01,01,01,01,01
01,01,01,01,01,01,01,90,28,28,28,90,83,01,01,83,90,28,28,28,90,01,01,01,01,01,01,01
01,01,01,01,01,01,01,90,111,28,28,90,03,01,01,03,90,28,28,28,90,01,01,01,85,01,01,01
01,01,01,01,03,01,01,90,90,28,90,90,90,01,01,90,90,90,90,28,90,01,01,01,01,01,01,01
01,01,01,01,01,01,01,90,28,28,28,28,28,28,28,28,28,28,28,28,90,01,01,01,01,01,01,01
01,01,01,01,01,01,01,90,28,28,28,28,28,28,28,28,28,28,28,28,90,01,01,01,01,01,01,01
01,01,01,01,01,01,01,90,90,90,90,90,90,87,87,90,90,90,90,90,90,01,01,01,01,01,01,01
00,00,00,00,00,00,00,00,00,00,00,00,00,00,00,00,00,00,00,00,00,00,00,00,00,00,00,00
00,00,00,00,00,00,00,00,00,00,00,00,00,00,00,00,00,00,00,00,00,00,00,00,00,00,00,00
00,00,00,00,00,00,00,00,00,00,00,00,00,00,00,00,00,00,00,00,00,00,00,00,00,00,00,00
00,00,00,00,00,00,00,00,00,00,00,00,00,00,00,00,00,00,00,00,00,00,00,00,00,00,00,00