42,37
00,00,00,00,00,00,00,00,00,00,00,00,00,00,00,00,00,00,00,00,00,00,00,00,00,00,00,00,00,00,00,00,00,00,00,00,00,00,00,00,00,00
00,00,00,00,00,00,00,00,00,00,00,00,00,00,00,00,00,00,00,00,00,00,00,00,00,00,00,00,00,00,00,00,00,00,00,00,00,00,00,00,00,00
00,00,00,00,00,00,00,00,00,00,00,00,00,00,00,00,00,00,00,00,00,00,00,00,00,00,00,00,00,00,00,00,00,00,00,00,00,00,00,00,00,00
00,00,00,00,00,00,00,00,00,00,00,00,00,00,00,00,00,00,00,00,00,00,00,00,00,00,00,00,00,00,00,00,00,00,00,00,00,00,00,00,00,00
00,00,00,00,00,00,00,87,87,87,87,87,87,87,87,87,87,87,87,87,87,87,87,87,87,87,87,87,87,87,87,87,87,87,87,00,00,00,00,00,00,00
00,00,00,00,00,00,00,87,03,03,01,03,01,01,03,01,03,03,01,03,01,03,03,40,03,01,03,85,03,01,01,03,03,03,87,00,00,00,00,00,00,00
00,00,00,00,00,00,00,87,03,57,57,57,57,57,57,57,03,01,85,03,03,01,03,40,03,03,01,01,01,03,01,03,03,50,87,00,00,00,00,00,00,00
00,00,00,00,00,00,00,87,84,57,99,28,28,36,37,57,01,01,01,01,01,01,03,40,03,01,84,01,03,85,01,01,03,84,87,00,00,00,00,00,00,00
00,00,00,00,00,00,00,87,01,57,28,28,28,28,28,57,01,03,03,01,84,03,01,40,03,01,03,01,01,01,03,01,01,01,87,00,00,00,00,00,00,00
00,00,00,00,00,00,00,87,03,57,28,28,74,28,28,40,40,40,40,40,40,40,40,40,85,01,03,01,01,03,01,01,84,03,87,00,00,00,00,00,00,00
00,00,00,00,00,00,00,87,01,57,100,28,28,28,28,57,03,01,01,03,03,03,84,40,01,03,03,01,03,01,01,03,84,85,87,00,00,00,00,00,00,00
00,00,00,00,00,00,00,87,84,57,99,28,28,28,28,57,03,03,01,01,03,01,03,40,01,57,57,57,57,57,57,57,57,57,87,00,00,00,00,00,00,00
00,00,00,00,00,00,00,87,01,57,57,57,57,57,57,57,01,85,03,03,03,01,01,40,01,57,28,28,28,28,28,28,28,57,87,00,00,00,00,00,00,00
00,00,00,00,00,00,00,87,01,03,03,01,01,84,03,01,01,01,03,01,01,01,01,40,40,40,28,28,28,57,28,28,28,57,87,00,00,00,00,00,00,00
00,00,00,00,00,00,00,87,03,03,01,01,85,01,01,01,03,01,01,01,01,03,01,40,03,57,33,69,33,57,28,28,28,57,87,00,00,00,00,00,00,00
00,00,00,00,00,00,00,87,01,01,84,01,03,03,01,57,57,57,57,57,57,01,03,40,03,57,28,45,28,57,28,28,28,57,87,00,00,00,00,00,00,00
00,00,00,00,00,00,00,87,03,01,85,84,01,03,03,57,28,32,28,28,57,01,01,40,01,57,57,57,57,57,57,57,57,57,87,00,00,00,00,00,00,00
00,00,00,00,00,00,00,87,03,03,01,01,03,01,01,57,28,32,28,28,40,40,40,40,84,01,01,03,03,84,03,01,01,03,87,00,00,00,00,00,00,00
00,00,00,00,00,00,00,87,01,01,03,01,03,03,01,57,45,55,28,28,57,03,03,40,01,01,03,03,01,01,01,03,03,01,87,00,00,00,00,00,00,00
00,00,00,00,00,00,00,87,01,01,01,01,01,03,01,57,28,32,28,28,57,85,01,40,03,01,01,84,03,57,57,57,57,57,87,00,00,00,00,00,00,00
00,00,00,00,00,00,00,87,84,01,01,03,01,01,01,57,57,57,57,57,57,01,03,40,03,85,01,01,01,57,40,40,40,57,87,00,00,00,00,00,00,00
00,00,00,00,00,00,00,87,01,03,01,48,01,01,03,03,01,01,84,84,03,03,01,40,40,40,40,40,40,40,40,40,72,57,87,00,00,00,00,00,00,00
00,00,00,00,00,00,00,87,03,01,01,01,03,03,01,01,03,03,01,01,03,01,01,01,03,03,40,03,84,57,40,40,40,57,87,00,00,00,00,00,00,00
00,00,00,00,00,00,00,87,01,01,03,01,01,03,03,01,01,03,03,01,03,84,03,03,03,03,40,84,03,57,57,57,57,57,87,00,00,00,00,00,00,00
00,00,00,00,00,00,00,87,03,01,01,03,01,01,84,03,03,01,85,01,01,01,01,03,01,01,40,03,01,01,03,85,85,03,87,00,00,00,00,00,00,00
00,00,00,00,00,00,00,87,01,01,03,01,01,03,01,01,84,84,03,01,01,03,57,57,57,57,40,57,57,57,03,01,01,01,87,00,00,00,00,00,00,00
00,00,00,00,00,00,00,87,03,03,85,01,01,03,01,03,01,03,01,01,03,03,57,28,28,28,28,28,28,57,01,03,03,03,87,00,00,00,00,00,00,00
00,00,00,00,00,00,00,87,01,01,03,03,84,01,01,01,84,03,03,01,01,03,57,64,28,28,28,28,28,57,85,01,01,03,87,00,00,00,00,00,00,00
00,00,00,00,00,00,00,87,03,01,01,85,03,01,03,03,01,01,01,01,03,01,57,28,28,28,28,28,28,57,01,01,84,03,87,00,00,00,00,00,00,00
00,00,00,00,00,00,00,87,03,03,01,01,03,03,01,01,03,03,01,01,01,84,57,33,33,33,66,33,33,57,03,01,01,01,87,00,00,00,00,00,00,00
00,00,00,00,00,00,00,87,01,01,03,03,85,01,01,01,01,84,01,01,03,03,57,28,28,28,45,28,28,57,03,03,03,03,87,00,00,00,00,00,00,00
00,00,00,00,00,00,00,87,01,01,03,01,01,03,03,01,03,01,03,03,03,01,57,57,57,57,57,57,57,57,85,03,84,03,87,00,00,00,00,00,00,00
00,00,00,00,00,00,00,87,87,87,87,87,87,87,87,87,87,87,87,87,87,87,87,87,87,87,87,87,87,87,87,87,87,87,87,00,00,00,00,00,00,00
00,00,00,00,00,00,00,00,00,00,00,00,00,00,00,00,00,00,00,00,00,00,00,00,00,00,00,00,00,00,00,00,00,00,00,00,00,00,00,00,00,00
00,00,00,00,00,00,00,00,00,00,00,00,00,00,00,00,00,00,00,00,00,00,00,00,00,00,00,00,00,00,00,00,00,00,00,00,00,00,00,00,00,00
00,00,00,00,00,00,00,00,00,00,00,00,00,00,00,00,00,00,00,00,00,00,00,00,00,00,00,00,00,00,00,00,00,00,00,00,00,00,00,00,00,00
00,00,00,00,00,00,00,00,00,00,00,00,00,00,00,00,00,00,00,00,00,00,00,00,00,00,00,00,00,00,00,00,00,00,00,00,00,00,00,00,00,00