49,45
00,00,00,00,00,00,00,00,00,00,00,00,00,00,00,00,00,00,00,00,00,00,00,00,00,00,00,00,00,00,00,00,00,00,00,00,00,00,00,00,00,00,00,00,00,00,00,00,00
00,00,00,00,00,00,00,00,00,00,00,00,00,00,00,00,00,00,00,00,00,00,00,00,00,00,00,00,00,00,00,00,00,00,00,00,00,00,00,00,00,00,00,00,00,00,00,00,00
00,00,00,00,00,00,00,00,00,00,00,00,00,00,00,00,00,00,00,00,00,00,00,00,00,00,00,00,00,00,00,00,00,00,00,00,00,00,00,00,00,00,00,00,00,00,00,00,00
00,00,00,00,00,00,00,00,00,00,00,00,00,00,00,00,00,00,00,00,00,00,00,00,00,00,00,00,00,00,00,00,00,00,00,00,00,00,00,00,00,00,00,00,00,00,00,00,00
00,00,00,00,00,00,00,29,29,29,29,29,29,29,29,29,29,29,29,29,29,29,29,29,29,29,29,29,29,29,29,29,29,29,29,29,29,29,29,29,29,29,00,00,00,00,00,00,00
00,00,00,00,00,00,00,29,03,01,01,01,01,01,01,01,01,01,84,01,01,01,01,01,01,01,01,01,01,01,03,90,90,90,90,90,90,90,90,90,03,29,00,00,00,00,00,00,00
00,00,00,00,00,00,00,29,01,01,01,01,01,01,01,01,01,01,01,01,01,01,01,01,85,01,01,01,01,01,03,90,36,37,28,28,28,36,37,90,03,29,00,00,00,00,00,00,00
00,00,00,00,00,00,00,29,01,01,01,84,01,01,01,01,01,01,01,01,01,01,01,01,01,01,01,01,01,01,03,90,38,28,28,28,28,28,28,90,03,29,00,00,00,00,00,00,00
00,00,00,00,00,00,00,29,01,01,01,01,01,01,01,01,01,01,01,01,01,01,03,01,01,42,01,01,01,01,03,90,39,28,60,28,28,28,28,27,27,29,00,00,00,00,00,00,00
00,00,00,00,00,00,00,29,85,04,04,04,04,04,04,04,04,01,01,01,01,01,01,01,01,01,01,01,01,01,03,90,28,28,28,28,28,28,28,90,27,29,00,00,00,00,00,00,00
00,00,00,00,00,00,00,29,01,04,28,28,36,37,28,28,04,01,01,01,01,01,01,01,01,01,01,03,01,01,03,90,28,28,28,28,28,100,99,90,27,29,00,00,00,00,00,00,00
00,00,00,00,00,00,00,29,01,04,63,28,28,28,28,28,04,01,01,01,01,01,01,01,01,01,01,01,01,01,03,90,90,90,90,90,90,90,90,90,27,29,00,00,00,00,00,00,00
00,00,00,00,00,00,00,29,03,04,28,28,28,28,28,28,04,01,01,01,01,03,01,01,01,01,01,01,01,01,03,03,03,03,03,03,03,03,03,03,27,29,00,00,00,00,00,00,00
00,00,00,00,00,00,00,29,01,04,04,04,27,04,04,04,04,03,01,01,01,01,01,01,01,01,84,01,01,01,01,01,01,01,01,01,01,01,01,01,27,29,00,00,00,00,00,00,00
00,00,00,00,00,00,00,29,01,01,84,01,27,27,27,27,27,27,27,27,27,27,27,27,27,27,27,27,27,27,27,27,27,27,27,27,27,27,27,27,27,29,00,00,00,00,00,00,00
00,00,00,00,00,00,00,29,01,01,01,03,27,27,27,27,27,27,27,27,27,27,27,27,27,27,27,27,27,27,27,27,27,27,27,27,27,27,27,27,27,29,00,00,00,00,00,00,00
00,00,00,00,00,00,00,29,01,01,01,01,01,01,01,01,01,01,01,01,27,27,03,01,01,01,01,01,01,27,01,01,01,01,01,27,03,01,01,01,01,29,00,00,00,00,00,00,00
00,00,00,00,00,00,00,29,01,01,01,01,85,01,01,01,01,01,01,01,27,27,01,01,01,01,05,05,05,27,05,05,05,05,05,27,05,05,05,85,01,29,00,00,00,00,00,00,00
00,00,00,00,00,00,00,29,01,01,01,01,01,01,01,01,01,01,01,01,27,27,01,01,01,01,05,28,28,28,28,28,05,28,28,28,28,28,05,03,84,29,00,00,00,00,00,00,00
00,00,00,00,00,00,00,29,84,01,01,01,01,01,01,01,01,01,01,01,27,27,01,01,01,01,05,28,28,28,28,38,05,38,28,28,28,28,05,01,01,29,00,00,00,00,00,00,00
00,00,00,00,00,00,00,29,01,01,01,85,29,29,29,29,29,29,01,03,27,27,27,27,27,27,27,28,28,28,28,39,05,39,28,28,28,28,05,01,01,29,00,00,00,00,00,00,00
00,00,00,00,00,00,00,29,01,01,01,01,29,28,32,28,28,29,01,01,27,27,84,01,01,01,05,28,28,28,28,28,05,28,28,28,28,28,05,01,01,29,00,00,00,00,00,00,00
00,00,00,00,00,00,00,29,01,01,01,01,29,28,32,28,28,29,03,01,27,27,01,01,01,01,05,28,28,28,28,28,05,100,99,28,28,64,05,01,85,29,00,00,00,00,00,00,00
00,00,00,00,00,00,00,29,01,01,01,01,29,45,54,28,28,27,27,27,27,27,01,01,01,01,05,05,05,05,05,05,05,05,05,05,05,05,05,01,01,29,00,00,00,00,00,00,00
00,00,00,00,00,00,00,29,01,03,01,01,29,28,32,28,28,29,03,01,27,27,01,01,03,01,05,28,36,37,28,28,05,01,01,01,03,01,01,01,01,29,00,00,00,00,00,00,00
00,00,00,00,00,00,00,29,01,01,01,01,29,28,32,28,28,29,01,84,27,27,01,01,01,01,05,28,28,28,28,28,05,01,01,01,01,01,01,01,01,29,00,00,00,00,00,00,00
00,00,00,00,00,00,00,29,01,01,01,01,29,29,29,29,29,29,01,01,27,27,27,27,27,27,27,28,28,28,28,28,05,01,01,50,01,01,01,01,01,29,00,00,00,00,00,00,00
00,00,00,00,00,00,00,29,01,85,01,01,01,01,03,01,01,01,01,01,27,27,01,01,01,01,05,28,28,101,28,28,05,01,01,01,01,01,01,01,01,29,00,00,00,00,00,00,00
00,00,00,00,00,00,00,29,01,01,01,01,01,01,01,01,01,01,01,01,27,27,01,01,01,01,05,28,28,28,28,99,05,01,01,01,01,01,01,84,01,29,00,00,00,00,00,00,00
00,00,00,00,00,00,00,29,01,01,01,01,29,29,29,29,29,29,01,01,27,27,01,01,01,01,05,05,05,05,05,05,05,01,01,01,01,01,01,01,01,29,00,00,00,00,00,00,00
00,00,00,00,00,00,00,29,01,01,01,01,29,45,28,32,28,27,27,27,27,27,01,01,01,01,01,01,01,01,01,01,01,01,01,01,01,01,01,01,01,29,00,00,00,00,00,00,00
00,00,00,00,00,00,00,29,01,01,01,01,29,69,33,35,28,29,01,01,27,27,01,01,01,01,01,01,03,03,01,01,01,01,01,01,01,01,01,01,01,29,00,00,00,00,00,00,00
00,00,00,00,00,00,00,29,01,01,01,01,29,28,28,28,28,29,01,01,27,27,01,01,01,01,01,03,03,03,01,01,01,01,01,01,03,03,03,01,01,29,00,00,00,00,00,00,00
00,00,00,00,00,00,00,29,01,01,01,01,29,28,29,29,29,29,01,01,27,27,01,01,01,01,01,01,03,84,01,01,01,01,01,03,03,03,03,03,01,29,00,00,00,00,00,00,00
00,00,00,00,00,00,00,29,01,01,01,01,29,28,28,28,99,29,01,01,27,27,01,01,01,01,01,01,01,01,01,01,01,85,01,03,03,03,03,03,01,29,00,00,00,00,00,00,00
00,00,00,00,00,00,00,29,01,01,03,01,29,28,28,28,28,29,01,01,27,27,01,85,01,01,01,01,01,01,01,01,01,01,03,03,03,03,03,03,01,29,00,00,00,00,00,00,00
00,00,00,00,00,00,00,29,01,01,01,01,29,28,28,28,100,29,01,01,27,27,01,01,01,01,01,01,01,01,01,01,01,01,01,03,03,03,03,01,01,29,00,00,00,00,00,00,00
00,00,00,00,00,00,00,29,01,01,01,01,29,29,29,29,29,29,01,01,27,27,48,01,01,01,01,84,01,01,01,01,01,01,01,03,03,03,03,01,01,29,00,00,00,00,00,00,00
00,00,00,00,00,00,00,29,42,84,84,01,01,01,01,03,01,01,01,01,27,27,01,01,01,01,01,01,01,01,01,01,01,01,01,01,03,03,03,01,01,29,00,00,00,00,00,00,00
00,00,00,00,00,00,00,29,29,29,29,29,29,29,29,29,29,29,29,29,27,27,29,29,29,29,29,29,29,29,29,29,29,29,29,29,29,29,29,29,29,29,00,00,00,00,00,00,00
00,00,00,00,00,00,00,00,00,00,00,00,00,00,00,00,00,00,00,00,87,87,00,00,00,00,00,00,00,00,00,00,00,00,00,00,00,00,00,00,00,00,00,00,00,00,00,00,00
00,00,00,00,00,00,00,00,00,00,00,00,00,00,00,00,00,00,00,00,00,00,00,00,00,00,00,00,00,00,00,00,00,00,00,00,00,00,00,00,00,00,00,00,00,00,00,00,00
00,00,00,00,00,00,00,00,00,00,00,00,00,00,00,00,00,00,00,00,00,00,00,00,00,00,00,00,00,00,00,00,00,00,00,00,00,00,00,00,00,00,00,00,00,00,00,00,00
00,00,00,00,00,00,00,00,00,00,00,00,00,00,00,00,00,00,00,00,00,00,00,00,00,00,00,00,00,00,00,00,00,00,00,00,00,00,00,00,00,00,00,00,00,00,00,00,00
00,00,00,00,00,00,00,00,00,00,00,00,00,00,00,00,00,00,00,00,00,00,00,00,00,00,00,00,00,00,00,00,00,00,00,00,00,00,00,00,00,00,00,00,00,00,00,00,00