45,39
00,00,00,00,00,00,00,00,00,00,00,00,00,00,00,00,00,00,00,00,00,00,00,00,00,00,00,00,00,00,00,00,00,00,00,00,00,00,00,00,00,00,00,00,00
00,00,00,00,00,00,00,00,00,00,00,00,00,00,00,00,00,00,00,00,00,00,00,00,00,00,00,00,00,00,00,00,00,00,00,00,00,00,00,00,00,00,00,00,00
00,00,00,00,00,00,00,00,00,00,00,00,00,00,00,00,00,00,00,00,00,00,00,00,00,00,00,00,00,00,00,00,00,00,00,00,00,00,00,00,00,00,00,00,00
00,00,00,00,00,00,00,00,00,00,00,00,00,00,00,00,00,00,00,00,00,00,00,00,00,00,00,00,00,00,00,00,00,00,00,00,00,00,00,00,00,00,00,00,00
00,00,00,00,00,00,00,87,87,87,87,87,87,87,87,87,87,87,87,87,87,87,87,87,87,87,87,87,87,87,87,87,87,87,87,87,87,87,00,00,00,00,00,00,00
00,00,00,00,00,00,00,87,01,01,01,01,01,01,01,01,01,01,01,01,01,01,01,01,01,01,01,04,04,04,04,04,04,04,04,04,04,87,00,00,00,00,00,00,00
00,00,00,00,00,00,00,87,01,01,84,01,01,01,03,01,01,01,01,01,01,01,01,01,01,01,01,04,99,100,28,28,28,36,37,28,04,87,00,00,00,00,00,00,00
00,00,00,00,00,00,00,87,01,01,01,01,01,03,01,05,05,05,05,05,01,01,01,01,01,27,27,28,28,28,28,28,28,28,28,38,04,87,00,00,00,00,00,00,00
00,00,00,00,00,00,00,87,01,05,05,05,05,05,01,05,88,88,88,05,01,01,01,01,01,27,85,04,28,28,45,28,28,28,28,39,04,87,00,00,00,00,00,00,00
00,00,00,00,00,00,00,87,01,05,88,88,88,05,01,05,88,88,88,05,01,01,03,01,01,27,01,04,28,28,28,28,28,28,28,28,04,87,00,00,00,00,00,00,00
00,00,00,00,00,00,00,87,01,05,98,88,88,05,01,05,88,88,88,05,01,01,01,01,01,27,01,04,04,04,04,04,04,04,04,04,04,87,00,00,00,00,00,00,00
00,00,00,00,00,00,00,87,03,05,88,88,88,05,01,05,05,88,05,05,01,01,48,01,01,27,01,01,01,01,01,84,84,03,01,01,01,87,00,00,00,00,00,00,00
00,00,00,00,00,00,00,87,01,05,88,88,88,88,27,27,27,27,27,27,27,27,27,27,27,27,01,01,01,01,01,03,01,01,01,01,01,87,00,00,00,00,00,00,00
00,00,00,00,00,00,00,87,01,05,05,05,05,05,84,01,01,27,01,01,01,01,01,27,27,03,01,01,01,01,01,01,01,03,01,01,01,87,00,00,00,00,00,00,00
00,00,00,00,00,00,00,87,01,01,01,01,01,01,01,01,01,27,01,01,01,01,01,27,27,01,01,01,29,29,29,29,29,29,01,01,01,87,00,00,00,00,00,00,00
00,00,00,00,00,00,00,87,01,01,01,01,01,01,01,01,01,27,01,01,01,01,01,27,27,01,01,01,29,28,28,32,28,29,01,01,03,87,00,00,00,00,00,00,00
00,00,00,00,00,00,00,87,01,01,01,01,90,90,90,90,90,28,90,90,90,01,01,27,27,01,01,01,29,28,28,32,28,29,01,01,01,87,00,00,00,00,00,00,00
00,00,00,00,00,00,00,87,03,03,01,01,90,32,74,28,28,28,28,64,90,01,01,27,27,27,27,27,28,28,28,54,45,29,01,84,01,87,00,00,00,00,00,00,00
00,00,00,00,00,00,00,87,03,03,03,01,90,32,28,28,28,28,28,28,90,01,01,27,27,01,01,01,29,28,28,32,28,29,01,01,01,87,00,00,00,00,00,00,00
00,00,00,00,00,00,00,87,03,03,03,01,90,55,28,28,28,28,28,28,28,27,27,27,27,01,01,01,29,28,28,32,28,29,03,01,03,87,00,00,00,00,00,00,00
00,00,00,00,00,00,00,87,03,03,01,01,90,32,28,28,28,28,28,32,90,01,01,27,27,01,01,01,29,29,29,29,29,29,01,01,01,87,00,00,00,00,00,00,00
00,00,00,00,00,00,00,87,03,03,01,01,90,34,33,70,33,66,33,35,90,01,01,27,27,03,01,01,01,01,85,01,01,01,01,01,01,87,00,00,00,00,00,00,00
00,00,00,00,00,00,00,87,03,03,48,01,90,90,90,90,90,90,90,90,90,01,01,27,27,01,01,01,01,01,50,01,01,01,01,84,01,87,00,00,00,00,00,00,00
00,00,00,00,00,00,00,87,84,01,01,01,01,03,84,01,01,01,01,01,01,01,01,27,27,01,01,01,01,01,01,01,01,01,01,01,01,87,00,00,00,00,00,00,00
00,00,00,00,00,00,00,87,01,01,29,29,29,29,29,29,01,01,01,01,01,01,01,27,27,01,01,01,01,03,03,01,01,01,01,01,01,87,00,00,00,00,00,00,00
00,00,00,00,00,00,00,87,01,01,29,28,32,28,28,29,03,01,01,01,01,01,01,27,27,01,01,01,01,01,01,01,01,01,01,01,01,87,00,00,00,00,00,00,00
00,00,00,00,00,00,00,87,01,01,29,45,53,28,28,28,27,27,27,27,27,27,27,27,27,27,27,27,27,71,01,01,01,01,01,01,01,87,00,00,00,00,00,00,00
00,00,00,00,00,00,00,87,01,01,29,33,35,28,28,28,27,27,27,27,27,27,27,27,27,27,27,27,27,27,01,01,01,01,01,01,01,87,00,00,00,00,00,00,00
00,00,00,00,00,00,00,87,01,01,29,28,28,28,28,29,03,01,01,01,01,01,01,01,01,01,01,01,27,27,01,01,01,01,01,01,01,87,00,00,00,00,00,00,00
00,00,00,00,00,00,00,87,01,01,29,28,29,29,29,29,01,01,01,01,01,01,01,01,01,01,01,01,27,27,01,01,01,01,01,01,01,87,00,00,00,00,00,00,00
00,00,00,00,00,00,00,87,01,01,29,28,29,99,100,29,01,01,01,84,01,01,01,01,01,01,01,01,27,27,01,01,01,01,01,01,01,87,00,00,00,00,00,00,00
00,00,00,00,00,00,00,87,01,01,29,28,28,28,28,29,01,01,01,01,01,01,01,01,85,01,01,84,27,27,84,01,01,01,01,01,01,87,00,00,00,00,00,00,00
00,00,00,00,00,00,00,87,01,01,29,28,29,28,28,29,01,01,01,01,01,01,01,01,01,01,01,84,27,27,84,01,01,01,01,03,01,87,00,00,00,00,00,00,00
00,00,00,00,00,00,00,87,01,01,29,29,29,29,29,29,01,01,01,01,01,01,01,01,01,01,01,84,27,27,84,01,01,01,01,01,01,87,00,00,00,00,00,00,00
00,00,00,00,00,00,00,87,87,87,87,87,87,87,87,87,87,87,87,87,87,87,87,87,87,87,87,87,87,87,87,87,87,87,87,87,87,87,00,00,00,00,00,00,00
00,00,00,00,00,00,00,00,00,00,00,00,00,00,00,00,00,00,00,00,00,00,00,00,00,00,00,00,00,00,00,00,00,00,00,00,00,00,00,00,00,00,00,00,00
00,00,00,00,00,00,00,00,00,00,00,00,00,00,00,00,00,00,00,00,00,00,00,00,00,00,00,00,00,00,00,00,00,00,00,00,00,00,00,00,00,00,00,00,00
00,00,00,00,00,00,00,00,00,00,00,00,00,00,00,00,00,00,00,00,00,00,00,00,00,00,00,00,00,00,00,00,00,00,00,00,00,00,00,00,00,00,00,00,00
00,00,00,00,00,00,00,00,00,00,00,00,00,00,00,00,00,00,00,00,00,00,00,00,00,00,00,00,00,00,00,00,00,00,00,00,00,00,00,00,00,00,00,00,00
